Date,Location,ShortName,LongName,Administered_Daily,Administered_Cumulative,Administered_7_Day_Rolling_Average,Admin_Dose_1_Daily,Admin_Dose_1_Cumulative,Admin_Dose_1_Day_Rolling_Average,Admin_Dose_2_Daily,Admin_Dose_2_Cumulative,Admin_Dose_2_Day_Rolling_Average,date_type,Administered_daily_change_report,Administered_daily_change_report_7dayroll
2020-12-13,US,USA,United States,45620,45620,45620,36817,36817,36817,9669,9669,9669,Admin,,
2020-12-14,US,USA,United States,4848,50468,25234,4648,41465,20733,164,9833,4917,Admin,,
2020-12-15,US,USA,United States,47885,98353,32784,46418,87883,29294,328,10161,3387,Admin,,
2020-12-16,US,USA,United States,160151,258504,64626,155515,243398,60850,518,10679,2670,Admin,,
2020-12-17,US,USA,United States,275238,533742,106748,268246,511644,102329,826,11505,2301,Admin,,
2020-12-18,US,USA,United States,421048,954790,159132,411578,923222,153870,1326,12831,2139,Admin,,
2020-12-19,US,USA,United States,184213,1139003,162715,179798,1103020,157574,1159,13990,1999,Admin,,
2020-12-20,US,USA,United States,107199,1246202,171512,104910,1207930,167302,823,14813,735,Admin,,
2020-12-21,US,USA,United States,387101,1633303,226119,379414,1587344,220840,1674,16487,951,Admin,,
2020-12-22,US,USA,United States,451272,2084575,283746,441940,2029284,277343,3016,19503,1335,Admin,,
2020-12-23,US,USA,United States,578305,2662880,343482,566144,2595428,336004,3266,22769,1727,Admin,,
2020-12-24,US,USA,United States,197901,2860781,332434,192869,2788297,325236,1248,24017,1787,Admin,,
2020-12-25,US,USA,United States,12843,2873624,274119,12638,2800935,268245,138,24155,1618,Admin,,
2020-12-26,US,USA,United States,143534,3017158,268308,139914,2940849,262547,1070,25225,1605,Admin,,
2020-12-27,US,USA,United States,96869,3114027,266832,93941,3034790,260980,809,26034,1603,Admin,,
2020-12-28,US,USA,United States,597529,3711556,296893,582215,3617005,289952,4487,30521,2005,Admin,,
2020-12-29,US,USA,United States,729136,4440692,336588,709184,4326189,328129,5512,36033,2361,Admin,,
2020-12-30,US,USA,United States,848917,5289609,375247,828231,5154420,365570,7671,43704,2991,Admin,,
2020-12-31,US,USA,United States,426703,5716312,407933,415864,5570284,397427,3537,47241,3318,Admin,,
2021-01-01,US,USA,United States,137862,5854174,425793,124353,5694637,413386,9356,56597,4635,Admin,,
2021-01-02,US,USA,United States,268950,6123124,443709,259530,5954167,430474,3112,59709,4926,Admin,,
2021-01-03,US,USA,United States,141399,6264523,450071,133812,6087979,436170,2594,62303,5181,Admin,,
2021-01-04,US,USA,United States,665706,6930229,459810,605569,6693548,439506,45667,107970,11064,Admin,,
2021-01-05,US,USA,United States,840779,7771008,475759,738359,7431907,443674,88552,196522,22927,Admin,,
2021-01-06,US,USA,United States,1030603,8801611,501715,836232,8268139,444817,174965,371487,46826,Admin,,
2021-01-07,US,USA,United States,1177715,9979326,609002,870506,9138645,509766,284151,655638,86914,Admin,,
2021-01-08,US,USA,United States,1244741,11224067,767128,850665,9989310,613525,367995,1023633,138148,Admin,,
2021-01-09,US,USA,United States,512629,11736696,801939,372070,10361380,629602,130042,1153675,156281,Admin,,
2021-01-10,US,USA,United States,253088,11989784,817894,177568,10538948,635853,69895,1223570,165895,Admin,,
2021-01-11,US,USA,United States,1079145,13068929,876957,726303,11265251,653100,327062,1550632,206095,Admin,,
2021-01-12,US,USA,United States,1265924,14334853,937692,921829,12187080,679310,317487,1868119,238800,Admin,,
2021-01-13,US,USA,United States,1334854,15669707,981157,1035910,13222990,707836,273329,2141448,252852,Admin,,
2021-01-14,US,USA,United States,1325745,16995452,1002304,1162062,14385052,749487,137705,2279153,231931,Admin,,
2021-01-15,US,USA,United States,1268589,18264041,1005711,1123898,15508950,788520,122636,2401789,196879,Admin,,
2021-01-16,US,USA,United States,651783,18915824,1025590,568025,16076975,816514,73202,2474991,188759,Admin,,
2021-01-17,US,USA,United States,302512,19218336,1032650,256272,16333247,827757,42275,2517266,184814,Admin,,
2021-01-18,US,USA,United States,891805,20110141,1005887,644863,16978110,816123,229498,2746764,170876,Admin,,
2021-01-19,US,USA,United States,1353803,21463944,1018442,968717,17946827,822821,360817,3107581,177066,Admin,,
2021-01-20,US,USA,United States,1615237,23079181,1058496,1161663,19108490,840786,424920,3532501,198722,Admin,,
2021-01-21,US,USA,United States,1647635,24726816,1104481,1339290,20447780,866104,278914,3811415,218895,Admin,,
2021-01-22,US,USA,United States,1646871,26373687,1158521,1406081,21853861,906416,213070,4024485,231814,Admin,,
2021-01-23,US,USA,United States,913376,27287063,1195891,744595,22598456,931640,153321,4177806,243259,Admin,,
2021-01-24,US,USA,United States,403869,27690932,1210371,307475,22905931,938955,89536,4267342,250011,Admin,,
2021-01-25,US,USA,United States,1384839,29075771,1280804,865443,23771374,970466,494263,4761605,287834,Admin,,
2021-01-26,US,USA,United States,1670866,30746637,1326099,1055503,24826877,982864,586347,5347952,320053,Admin,,
2021-01-27,US,USA,United States,1938126,32684763,1372226,1250522,26077399,995558,652746,6000698,352600,Admin,,
2021-01-28,US,USA,United States,1970489,34655252,1418348,1370607,27448006,1000032,563072,6563770,393194,Admin,,
2021-01-29,US,USA,United States,1925120,36580372,1458098,1376719,28824725,995838,500161,7063931,434207,Admin,,
2021-01-30,US,USA,United States,1022132,37602504,1473634,757142,29581867,997630,245510,7309441,447376,Admin,,
2021-01-31,US,USA,United States,463792,38066296,1482195,322833,29904700,999824,129581,7439022,453097,Admin,,
2021-02-01,US,USA,United States,1418713,39485009,1487034,784578,30689278,988272,586674,8025696,466299,Admin,,
2021-02-02,US,USA,United States,1712809,41197818,1493026,968833,31658111,975891,706145,8731841,483413,Admin,,
2021-02-03,US,USA,United States,2153875,43351693,1523847,1264008,32922119,977817,841492,9573333,510376,Admin,,
2021-02-04,US,USA,United States,2356981,45708674,1579060,1387982,34310101,980299,920357,10493690,561417,Admin,,
2021-02-05,US,USA,United States,2367879,48076553,1642312,1357151,35667252,977504,968100,11461790,628266,Admin,,
2021-02-06,US,USA,United States,1307249,49383802,1683043,853771,36521023,991308,425151,11886941,653929,Admin,,
2021-02-07,US,USA,United States,443492,49827294,1680143,275196,36796219,984503,158148,12045089,658010,Admin,,
2021-02-08,US,USA,United States,1587115,51414409,1704200,838835,37635054,992254,710683,12755772,675725,Admin,,
2021-02-09,US,USA,United States,1981949,53396358,1742649,1036268,38671322,1001887,903396,13659168,703904,Admin,,
2021-02-10,US,USA,United States,2318275,55714633,1766134,1231077,39902399,997183,1045270,14704438,733015,Admin,,
2021-02-11,US,USA,United States,2421414,58136047,1775339,1277220,41179619,981360,1100721,15805159,758781,Admin,,
2021-02-12,US,USA,United States,2605164,60741211,1809237,1387302,42566921,985667,1166494,16971653,787123,Admin,,
2021-02-13,US,USA,United States,1478506,62219717,1833702,873070,43439991,988424,574230,17545883,808420,Admin,,
2021-02-14,US,USA,United States,591389,62811106,1854830,343863,43783854,998234,231630,17777513,818918,Admin,,
2021-02-15,US,USA,United States,1198939,64010045,1799377,617658,44401512,966637,545488,18323001,795318,Admin,,
2021-02-16,US,USA,United States,1626390,65636435,1748582,797401,45198913,932513,792476,19115477,779473,Admin,,
2021-02-17,US,USA,United States,1974513,67610948,1699474,936319,46135232,890405,996093,20111570,772447,Admin,,
2021-02-18,US,USA,United States,1863271,69474219,1619739,833567,46968799,827026,980528,21092098,755277,Admin,,
2021-02-19,US,USA,United States,1971540,71445759,1529221,819288,47788087,745881,1103017,22195115,746209,Admin,,
2021-02-20,US,USA,United States,1311441,72757200,1505355,596255,48384342,706336,685209,22880324,762063,Admin,,
2021-02-21,US,USA,United States,601724,73358924,1506831,255060,48639402,693650,327141,23207465,775707,Admin,,
2021-02-22,US,USA,United States,1470034,74828958,1545559,615507,49254909,693342,809335,24016800,813400,Admin,,
2021-02-23,US,USA,United States,1946484,76775442,1591287,864446,50119355,702920,1034585,25051385,847987,Admin,,
2021-02-24,US,USA,United States,2535910,79311352,1671486,1244165,51363520,746898,1242680,26294065,883214,Admin,,
2021-02-25,US,USA,United States,2946420,82257772,1826222,1535729,52899249,847207,1351474,27645539,936206,Admin,,
2021-02-26,US,USA,United States,3122056,85379828,1990581,1669279,54568528,968634,1394887,29040426,977902,Admin,,
2021-02-27,US,USA,United States,1996210,87376038,2088405,1136915,55705443,1045872,823677,29864103,997683,Admin,,
2021-02-28,US,USA,United States,856651,88232689,2124824,531304,56236747,1085335,299767,30163870,993772,Admin,,
2021-03-01,US,USA,United States,2097845,90330534,2214511,1221036,57457783,1171839,813054,30976924,994303,Admin,,
2021-03-02,US,USA,United States,2474543,92805077,2289948,1464219,58922002,1257521,970459,31947383,985143,Admin,,
2021-03-03,US,USA,United States,2916589,95721666,2344331,1742563,60664565,1328721,1136429,33083812,969964,Admin,,
2021-03-04,US,USA,United States,3210078,98931744,2381996,1955645,62620210,1388709,1254004,34337816,956040,Admin,,
2021-03-05,US,USA,United States,3242013,102173757,2399133,2006005,64626215,1436812,1321222,35659038,945516,Admin,,
2021-03-06,US,USA,United States,2068679,104242436,2409485,1350879,65977094,1467379,873119,36532157,952579,Admin,,
2021-03-07,US,USA,United States,933604,105176040,2420479,677525,66654619,1488267,351854,36884011,960020,Admin,,
2021-03-08,US,USA,United States,2174179,107350219,2431384,1481925,68136544,1525537,864010,37748021,967300,Admin,,
2021-03-09,US,USA,United States,2724006,110074225,2467021,1812541,69949085,1575298,1096746,38844767,985341,Admin,,
2021-03-10,US,USA,United States,3145737,113219962,2499757,2072614,72021699,1622448,1283628,40128395,1006369,Admin,,
2021-03-11,US,USA,United States,3468822,116688784,2536720,2295391,74317090,1670983,1413445,41541840,1029146,Admin,,
2021-03-12,US,USA,United States,3453100,120141884,2566875,2135114,76452204,1689427,1542671,43084511,1060782,Admin,,
2021-03-13,US,USA,United States,2202082,122343966,2585933,1387417,77839621,1694647,1031672,44116183,1083432,Admin,,
2021-03-14,US,USA,United States,985889,123329855,2593402,646860,78486481,1690266,432379,44548562,1094936,Admin,,
2021-03-15,US,USA,United States,2282423,125612278,2608866,1496501,79982982,1692348,880010,45428572,1097222,Admin,,
2021-03-16,US,USA,United States,2893755,128506033,2633115,1933738,81916720,1709662,1063428,46492000,1092462,Admin,,
2021-03-17,US,USA,United States,3176658,131682691,2637533,2130789,84047509,1717973,1145696,47637696,1072757,Admin,,
2021-03-18,US,USA,United States,3402214,135084905,2628017,2292143,86339652,1717509,1218102,48855798,1044851,Admin,,
2021-03-19,US,USA,United States,3320369,138405274,2609056,2204510,88544162,1727423,1233105,50088903,1000627,Admin,,
2021-03-20,US,USA,United States,2165556,140570830,2603838,1418041,89962203,1731797,866732,50955635,977065,Admin,,
2021-03-21,US,USA,United States,1027911,141598741,2609841,683514,90645717,1737034,380701,51336336,969682,Admin,,
2021-03-22,US,USA,United States,2356851,143955592,2620473,1599832,92245549,1751795,815061,52151397,960404,Admin,,
2021-03-23,US,USA,United States,3059738,147015330,2644185,1977957,94223506,1758112,1161336,53312733,974390,Admin,,
2021-03-24,US,USA,United States,3553935,150569265,2698082,2204321,96427827,1768617,1434329,54747062,1015624,Admin,,
2021-03-25,US,USA,United States,3824588,154393853,2758421,2255561,98683388,1763391,1660363,56407425,1078804,Admin,,
2021-03-26,US,USA,United States,3813041,158206894,2828803,2088216,100771604,1746777,1813868,58221293,1161770,Admin,,
2021-03-27,US,USA,United States,2476025,160682919,2873156,1370929,102142533,1740047,1170520,59391813,1205168,Admin,,
2021-03-28,US,USA,United States,1211887,161894806,2899438,670862,102813395,1738240,553155,59944968,1229805,Admin,,
2021-03-29,US,USA,United States,2834089,164728895,2967615,1604931,104418326,1738968,1284050,61229018,1296803,Admin,,
2021-03-30,US,USA,United States,3593032,168321927,3043800,2010216,106428542,1743577,1671099,62900117,1369626,Admin,,
2021-03-31,US,USA,United States,4172798,172494725,3132209,2408064,108836606,1772683,1952552,64852669,1443658,Admin,,
2021-04-01,US,USA,United States,4581777,177076502,3240378,2530101,111366707,1811903,2270510,67123179,1530822,Admin,,
2021-04-02,US,USA,United States,3646531,180723033,3216591,2044080,113410787,1805598,1830836,68954015,1533246,Admin,,
2021-04-03,US,USA,United States,2307814,183030847,3192561,1324945,114735732,1799028,1164724,70118739,1532418,Admin,,
2021-04-04,US,USA,United States,765287,183796134,3128761,438000,115173732,1765762,372944,70491683,1506674,Admin,,
2021-04-05,US,USA,United States,3103280,186899414,3167217,1733875,116907607,1784183,1608055,72099738,1552960,Admin,,
2021-04-06,US,USA,United States,3975030,190874444,3221788,2283379,119190986,1823206,2090509,74190247,1612876,Admin,,
2021-04-07,US,USA,United States,4360623,195235067,3248620,2558598,121749584,1844711,2316896,76507143,1664925,Admin,,
2021-04-08,US,USA,United States,4503590,199738657,3237451,2559717,124309301,1848942,2534769,79041912,1702676,Admin,,
2021-04-09,US,USA,United States,4316477,204055134,3333157,2431771,126741072,1904326,2454159,81496071,1791722,Admin,,
2021-04-10,US,USA,United States,2895008,206950142,3417042,1724592,128465664,1961419,1667154,83163225,1863498,Admin,,
2021-04-11,US,USA,United States,1402874,208353016,3508126,833128,129298792,2017866,805580,83968805,1925303,Admin,,
2021-04-12,US,USA,United States,3026715,211379731,3497188,1642689,130941481,2004839,1730130,85698935,1942742,Admin,,
2021-04-13,US,USA,United States,3485403,214865134,3427241,1746229,132687710,1928103,1723063,87421998,1890250,Admin,,
2021-04-14,US,USA,United States,3709110,218574244,3334168,1738270,134425980,1810914,1931468,89353466,1835189,Admin,,
2021-04-15,US,USA,United States,3760683,222334927,3228039,1762977,136188957,1697094,1953888,91307354,1752206,Admin,,
2021-04-16,US,USA,United States,3615657,225950584,3127921,1651830,137840787,1585674,1924785,93232139,1676581,Admin,,
2021-04-17,US,USA,United States,2370336,228320920,3052968,1162622,139003409,1505392,1185842,94417981,1607822,Admin,,
2021-04-18,US,USA,United States,1136696,229457616,3014943,539022,139542431,1463377,584550,95002531,1576247,Admin,,
2021-04-19,US,USA,United States,2592258,232049874,2952878,1091983,140634414,1384705,1468173,96470704,1538824,Admin,,
2021-04-20,US,USA,United States,3239654,235289528,2917771,1365917,142000331,1330374,1838704,98309408,1555344,Admin,,
2021-04-21,US,USA,United States,3492126,238781654,2886773,1392076,143392407,1280918,2058518,100367926,1573494,Admin,,
2021-04-22,US,USA,United States,3510256,242291910,2850998,1414658,144807065,1231158,2057894,102425820,1588352,Admin,,
2021-04-23,US,USA,United States,3312333,245604243,2807666,1368596,146175661,1190696,1909888,104335708,1586224,Admin,,
2021-04-24,US,USA,United States,2216273,247820516,2785657,1003003,147178664,1167894,1196228,105531936,1587708,Admin,,
2021-04-25,US,USA,United States,996280,248816796,2765597,490324,147668988,1160937,498401,106030337,1575401,Admin,,
2021-04-26,US,USA,United States,2401182,251217978,2738301,942264,148611252,1139548,1438711,107469048,1571192,Admin,,
2021-04-27,US,USA,United States,2904468,254122446,2690417,1113825,149725077,1103535,1794582,109263630,1564889,Admin,,
2021-04-28,US,USA,United States,3098422,257220868,2634173,1150395,150875472,1069009,1971122,111234752,1552404,Admin,,
2021-04-29,US,USA,United States,3063169,260284037,2570304,1123654,151999126,1027437,1986197,113220949,1542161,Admin,,
2021-04-30,US,USA,United States,2925570,263209607,2515052,1124566,153123692,992576,1853325,115074274,1534081,Admin,,
2021-05-01,US,USA,United States,1873118,265082725,2466030,714913,153838605,951420,1177358,116251632,1531385,Admin,,
2021-05-02,US,USA,United States,882586,265965311,2449788,326632,154165237,928036,587591,116839223,1544127,Admin,,
2021-05-03,US,USA,United States,1973055,267938366,2388627,644163,154809400,885450,1404149,118243372,1539189,Admin,,
2021-05-04,US,USA,United States,2511357,270449723,2332468,821038,155630438,843623,1762213,120005585,1534565,Admin,,
2021-05-05,US,USA,United States,2564140,273013863,2256142,820652,156451090,796517,1816128,121821713,1512423,Admin,,
2021-05-06,US,USA,United States,2535570,275549433,2180771,783068,157234158,747862,1826557,123648270,1489617,Admin,,
2021-05-07,US,USA,United States,2523048,278072481,2123268,800178,158034336,701521,1796121,125444391,1481445,Admin,,
2021-05-08,US,USA,United States,1543482,279615963,2076177,506547,158540883,671754,1095283,126539674,1469720,Admin,,
2021-05-09,US,USA,United States,617375,280233338,2038290,204478,158745361,654303,439959,126979633,1448630,Admin,,
2021-05-10,US,USA,United States,1612418,281845756,1986770,484374,159229735,631476,1180033,128159666,1416613,Admin,,
2021-05-11,US,USA,United States,2057561,283903317,1921942,659127,159888862,608346,1458998,129618664,1373297,Admin,,
2021-05-12,US,USA,United States,2027113,285930430,1845224,646180,160535042,583422,1447029,131065693,1320569,Admin,,
2021-05-13,US,USA,United States,2289866,288220296,1810123,930699,161465741,604512,1416613,132482306,1262005,Admin,,
2021-05-14,US,USA,United States,2465506,290685802,1801903,1097233,162562974,646948,1445764,133928070,1211954,Admin,,
2021-05-15,US,USA,United States,1857778,292543580,1846802,911909,163474883,704857,998323,134926393,1198103,Admin,,
2021-05-16,US,USA,United States,937988,293481568,1892604,479685,163954568,744172,488926,135415319,1205098,Admin,,
2021-05-17,US,USA,United States,1832270,295313838,1924012,889997,164844565,802119,1017306,136432625,1181851,Admin,,
2021-05-18,US,USA,United States,2083612,297397450,1927733,995531,165840096,850176,1171531,137604156,1140785,Admin,,
2021-05-19,US,USA,United States,2098225,299495675,1937892,990827,166830923,899412,1186334,138790490,1103542,Admin,,
2021-05-20,US,USA,United States,2029518,301525193,1900700,923884,167754807,898438,1185097,139975587,1070469,Admin,,
2021-05-21,US,USA,United States,2072633,303597826,1844575,935382,168690189,875316,1215470,141191057,1037570,Admin,,
2021-05-22,US,USA,United States,1455556,305053382,1787115,731471,169421660,849540,776927,141967984,1005942,Admin,,
2021-05-23,US,USA,United States,660614,305713996,1747490,339497,169761157,829513,348377,142316361,985863,Admin,,
2021-05-24,US,USA,United States,1328689,307042685,1675550,637678,170398835,793467,757446,143073807,948740,Admin,,
2021-05-25,US,USA,United States,1446635,308489320,1584553,670945,171069780,747098,845534,143919341,902169,Admin,,
2021-05-26,US,USA,United States,1445477,309934797,1491303,664759,171734539,700517,845422,144764763,853468,Admin,,
2021-05-27,US,USA,United States,1357841,311292638,1395349,617864,172352403,656799,805620,145570383,799257,Admin,,
2021-05-28,US,USA,United States,1342232,312634870,1291006,610328,172962731,610363,793509,146363892,738976,Admin,,
2021-05-29,US,USA,United States,771139,313406009,1193232,384409,173347140,560783,423880,146787772,688541,Admin,,
2021-05-30,US,USA,United States,387215,313793224,1154175,201782,173548922,541109,206227,146993999,668234,Admin,,
2021-05-31,US,USA,United States,204488,313997712,993575,89744,173638666,462833,123127,147117126,577617,Admin,,
2021-06-01,US,USA,United States,1288397,315286109,970970,532587,174171253,443068,794845,147911971,570376,Admin,,
2021-06-02,US,USA,United States,1126492,316412601,925401,496676,174667929,419056,688202,148600173,547916,Admin,,
2021-06-03,US,USA,United States,1257190,317669791,911022,464973,175132902,397214,847533,149447706,553903,Admin,,
2021-06-04,US,USA,United States,1416527,319086318,921635,502222,175635124,381770,971424,150419130,579320,Admin,,
2021-06-05,US,USA,United States,1080089,320166407,965771,355636,175990760,377660,758974,151178104,627190,Admin,,
2021-06-06,US,USA,United States,520836,320687243,984860,172043,176162803,373412,366772,151544876,650125,Admin,,
2021-06-07,US,USA,United States,1081294,321768537,1110118,374249,176537052,414055,748957,152293833,739530,Admin,,
2021-06-08,US,USA,United States,1183148,322951685,1095082,404475,176941527,395753,825301,153119134,743880,Admin,,
2021-06-09,US,USA,United States,1174452,324126137,1101934,392717,177334244,380902,828486,153947620,763921,Admin,,
2021-06-10,US,USA,United States,1177092,325303229,1090491,405439,177739683,372397,821647,154769267,760223,Admin,,
2021-06-11,US,USA,United States,1240992,326544221,1065415,428958,178168641,361931,862394,155631661,744647,Admin,,
2021-06-12,US,USA,United States,899105,327443326,1039560,281653,178450294,351362,647381,156279042,728705,Admin,,
2021-06-13,US,USA,United States,395762,327839088,1021692,113511,178563805,343000,298883,156577925,719007,Admin,,
2021-06-14,US,USA,United States,920013,328759101,998652,332743,178896548,337071,625728,157203653,701403,Admin,,
2021-06-15,US,USA,United States,985384,329744485,970400,361349,179257897,330910,666894,157870547,678773,Admin,,
2021-06-16,US,USA,United States,951145,330695630,938499,358334,179616231,325998,636917,158507464,651406,Admin,,
2021-06-17,US,USA,United States,899781,331595411,898883,351517,179967748,318295,596072,159103536,619181,Admin,,
2021-06-18,US,USA,United States,928434,332523845,854232,368786,180336534,309699,602783,159706319,582094,Admin,,
2021-06-19,US,USA,United States,577590,333101435,808301,231306,180567840,302507,371650,160077969,542704,Admin,,
2021-06-20,US,USA,United States,278477,333379912,791546,112375,180680215,302344,177076,160255045,525303,Admin,,
2021-06-21,US,USA,United States,565665,333945577,740925,302432,180982647,298014,296532,160551577,478275,Admin,,
2021-06-22,US,USA,United States,760157,334705734,708750,324065,181306712,292688,472685,161024262,450531,Admin,,
2021-06-23,US,USA,United States,740774,335446508,678697,330867,181637579,288764,446040,161470302,423263,Admin,,
2021-06-24,US,USA,United States,703640,336150148,650677,318510,181956089,284049,421474,161891776,398320,Admin,,
2021-06-25,US,USA,United States,771393,336921541,628242,350728,182306817,281469,456966,162348742,377489,Admin,,
2021-06-26,US,USA,United States,501788,337423329,617413,225724,182532541,280672,297213,162645955,366855,Admin,,
2021-06-27,US,USA,United States,268862,337692191,616040,127178,182659719,282786,151668,162797623,363225,Admin,,
2021-06-28,US,USA,United States,557687,338249878,614900,275978,182935697,279007,308060,163105683,364872,Admin,,
2021-06-29,US,USA,United States,630717,338880595,596409,297593,183233290,275225,360390,163466073,348830,Admin,,
2021-06-30,US,USA,United States,636648,339517243,581534,308147,183541437,271980,354275,163820348,335721,Admin,,
2021-07-01,US,USA,United States,617692,340134935,569255,295701,183837138,268721,339567,164159915,324020,Admin,,
2021-07-02,US,USA,United States,623870,340758805,548181,306626,184143764,262421,344540,164504455,307959,Admin,,
2021-07-03,US,USA,United States,358857,341117662,527762,182110,184325874,256190,189836,164694291,292619,Admin,,
2021-07-04,US,USA,United States,50996,341168658,496638,28025,184353899,242026,27651,164721942,274903,Admin,,
2021-07-05,US,USA,United States,399032,341567690,473973,201932,184555831,231448,210028,164931970,260898,Admin,,
2021-07-06,US,USA,United States,587144,342154834,467748,274026,184829857,228081,340276,165272246,258025,Admin,,
2021-07-07,US,USA,United States,574028,342728862,458803,282972,185112829,224485,321933,165594179,253404,Admin,,
2021-07-08,US,USA,United States,567878,343296740,451686,288742,185401571,223490,312882,165907061,249592,Admin,,
2021-07-09,US,USA,United States,634791,343931531,453247,322368,185723939,225739,346733,166253794,249906,Admin,,
2021-07-10,US,USA,United States,402404,344333935,459468,211752,185935691,229974,208103,166461897,252515,Admin,,
2021-07-11,US,USA,United States,217524,344551459,483257,116942,186052633,242676,108709,166570606,264095,Admin,,
2021-07-12,US,USA,United States,523380,345074839,501021,275517,186328150,253188,275648,166846254,273469,Admin,,
2021-07-13,US,USA,United States,529772,345604611,492825,281665,186609815,254280,272920,167119174,263847,Admin,,
2021-07-14,US,USA,United States,535114,346139725,487266,284915,186894730,254557,274457,167393631,257065,Admin,,
2021-07-15,US,USA,United States,544396,346684121,483912,298802,187193532,255994,270592,167664223,251023,Admin,,
2021-07-16,US,USA,United States,625471,347309592,482580,346746,187540278,259477,304910,167969133,245048,Admin,,
2021-07-17,US,USA,United States,401130,347710722,482398,223950,187764228,261220,190114,168159247,242479,Admin,,
2021-07-18,US,USA,United States,234502,347945224,484824,135316,187899544,263844,106106,168265353,242107,Admin,,
2021-07-19,US,USA,United States,569321,348514545,491387,339364,188238908,272965,253642,168518995,238963,Admin,,
2021-07-20,US,USA,United States,604662,349119207,502085,370576,188609484,285667,258994,168777989,236974,Admin,,
2021-07-21,US,USA,United States,633122,349752329,516086,386718,188996202,300210,269991,169047980,236336,Admin,,
2021-07-22,US,USA,United States,654048,350406377,531751,418132,189414334,317257,261361,169309341,235017,Admin,,
2021-07-23,US,USA,United States,747928,351154305,549245,486661,189900995,337245,289098,169598439,232758,Admin,,
2021-07-24,US,USA,United States,463249,351617554,558119,301140,190202135,348272,174954,169773393,230592,Admin,,
2021-07-25,US,USA,United States,260361,351877915,561813,202143,190404278,357819,63969,169837362,224573,Admin,,
2021-07-26,US,USA,United States,646124,352524039,572785,447554,190851832,373275,222905,170060267,220182,Admin,,
2021-07-27,US,USA,United States,704561,353228600,587056,481340,191333172,389098,253448,170313715,219389,Admin,,
2021-07-28,US,USA,United States,723953,353952553,600032,492211,191825383,404169,261055,170574770,218113,Admin,,
2021-07-29,US,USA,United States,724372,354676925,610078,498915,192324298,415709,255075,170829845,217215,Admin,,
2021-07-30,US,USA,United States,841479,355518404,623443,578219,192902517,428789,295344,171125189,218107,Admin,,
2021-07-31,US,USA,United States,519728,356038132,631511,347786,193250303,435453,182300,171307489,219157,Admin,,
2021-08-01,US,USA,United States,339729,356377861,642849,231266,193481569,439613,101935,171409424,224580,Admin,,
2021-08-02,US,USA,United States,725756,357103617,654225,508701,193990270,448348,239977,171649401,227019,Admin,,
2021-08-03,US,USA,United States,767950,357871567,663281,540724,194530994,456832,255687,171905088,227339,Admin,,
2021-08-04,US,USA,United States,783649,358655216,671809,555115,195086109,465818,257630,172162718,226850,Admin,,
2021-08-05,US,USA,United States,799315,359454531,682515,563446,195649555,475037,266713,172429431,228512,Admin,,
2021-08-06,US,USA,United States,915972,360370503,693157,630432,196279987,482496,314026,172743457,231181,Admin,,
2021-08-07,US,USA,United States,563757,360934260,699447,385079,196665066,487823,191531,172934988,232500,Admin,,
2021-08-08,US,USA,United States,353926,361288186,701475,239582,196904648,489011,118748,173053736,234902,Admin,,
2021-08-09,US,USA,United States,789529,362077715,710585,523903,197428551,491183,289053,173342789,241913,Admin,,
2021-08-10,US,USA,United States,806862,362884577,716144,533745,197962296,490186,297713,173640502,247916,Admin,,
2021-08-11,US,USA,United States,775876,363660453,715034,502365,198464661,482650,298065,173938567,253693,Admin,,
2021-08-12,US,USA,United States,810936,364471389,716694,518125,198982786,476176,316493,174255060,260804,Admin,,
2021-08-13,US,USA,United States,955196,365426585,722297,584800,199567586,469657,391620,174646680,271889,Admin,,
2021-08-14,US,USA,United States,630364,366056949,731813,364457,199932043,466711,244448,174891128,279449,Admin,,
2021-08-15,US,USA,United States,403240,366460189,738858,212882,200144925,462897,162850,175053978,285749,Admin,,
2021-08-16,US,USA,United States,876968,367337157,751349,466887,200611812,454752,356247,175410225,295348,Admin,,
2021-08-17,US,USA,United States,931377,368268534,769137,493044,201104856,448937,365943,175776168,305095,Admin,,
2021-08-18,US,USA,United States,960825,369229359,795558,489317,201594173,447073,381417,176157585,317003,Admin,,
2021-08-19,US,USA,United States,952720,370182079,815813,482528,202076701,441988,383527,176541112,326579,Admin,,
2021-08-20,US,USA,United States,1116439,371298518,838848,540420,202617121,435648,481601,177022713,339433,Admin,,
2021-08-21,US,USA,United States,673278,371971796,844978,323840,202940961,429845,300378,177323091,347423,Admin,,
2021-08-22,US,USA,United States,394149,372365945,843679,186182,203127143,426031,181391,177504482,350072,Admin,,
2021-08-23,US,USA,United States,925964,373291909,850679,441862,203569005,422456,408322,177912804,357511,Admin,,
2021-08-24,US,USA,United States,956460,374248369,854262,462030,204031035,418026,417945,178330749,364940,Admin,,
2021-08-25,US,USA,United States,973295,375221664,856044,469446,204500481,415187,425861,178756610,371289,Admin,,
2021-08-26,US,USA,United States,996468,376218132,862293,475970,204976451,414250,435990,179192600,378784,Admin,,
2021-08-27,US,USA,United States,1177954,377396086,871081,533464,205509915,413256,543992,179736592,387697,Admin,,
2021-08-28,US,USA,United States,717058,378113144,877335,319153,205829068,412587,344595,180081187,394014,Admin,,
2021-08-29,US,USA,United States,433393,378546537,882942,193778,206022846,413672,207780,180288967,397784,Admin,,
2021-08-30,US,USA,United States,938466,379485003,884728,419336,206442182,410454,438446,180727413,402087,Admin,,
2021-08-31,US,USA,United States,944510,380429513,883021,423037,206865219,404883,430585,181157998,403893,Admin,,
2021-09-01,US,USA,United States,953481,381382994,880190,427230,207292449,398853,413501,181571499,402127,Admin,,
2021-09-02,US,USA,United States,900535,382283529,866485,402462,207694911,388351,404402,181975901,397614,Admin,,
2021-09-03,US,USA,United States,1045422,383328951,847552,453683,208148594,376954,492437,182468338,390249,Admin,,
2021-09-04,US,USA,United States,562330,383891281,825448,245754,208394348,366469,278779,182747117,380847,Admin,,
2021-09-05,US,USA,United States,367693,384258974,816062,167805,208562153,362758,174294,182921411,376063,Admin,,
2021-09-06,US,USA,United States,178113,384437087,707441,81494,208643647,314495,87278,183008689,325897,Admin,,
2021-09-07,US,USA,United States,916891,385353978,703495,355051,208998698,304783,484829,183493518,333646,Admin,,
2021-09-08,US,USA,United States,852196,386206174,689026,366537,209365235,296112,406495,183900013,332645,Admin,,
2021-09-09,US,USA,United States,855333,387061507,682568,373097,209738332,291917,402312,184302325,332346,Admin,,
2021-09-10,US,USA,United States,1043214,388104721,682253,451273,210189605,291573,504818,184807143,334115,Admin,,
2021-09-11,US,USA,United States,604458,388709179,688271,260203,210449808,293637,304648,185111791,337811,Admin,,
2021-09-12,US,USA,United States,354542,389063721,686392,158162,210607970,292260,176145,185287936,338075,Admin,,
2021-09-13,US,USA,United States,787033,389850754,773381,338454,210946424,328968,386958,185674894,380886,Admin,,
2021-09-14,US,USA,United States,756840,390607594,750517,317825,211264249,323650,381595,186056489,366139,Admin,,
2021-09-15,US,USA,United States,771402,391378996,738975,315504,211579753,316360,393054,186449543,364219,Admin,,
2021-09-16,US,USA,United States,767955,392146951,726492,313428,211893181,307836,395610,186845153,363261,Admin,,
2021-09-17,US,USA,United States,908447,393055398,707240,353050,212246231,293804,483934,187329087,360278,Admin,,
2021-09-18,US,USA,United States,524615,393580013,695833,205752,212451983,286025,277645,187606732,356420,Admin,,
2021-09-19,US,USA,United States,310811,393890824,689586,120927,212572910,280706,168492,187775224,355327,Admin,,
2021-09-20,US,USA,United States,704265,394595089,677762,270289,212843199,270968,359952,188135176,351469,Admin,,
2021-09-21,US,USA,United States,683785,395278874,667326,261550,213104749,262929,348306,188483482,346713,Admin,,
2021-09-22,US,USA,United States,670908,395949782,652969,255724,213360473,254389,338720,188822202,338951,Admin,,
2021-09-23,US,USA,United States,681279,396631061,640587,257618,213618091,246416,331115,189153317,329738,Admin,,
2021-09-24,US,USA,United States,990823,397621884,652355,321785,213939876,241949,415358,189568675,319941,Admin,,
2021-09-25,US,USA,United States,675553,398297437,673918,200409,214140285,241186,230547,189799222,313213,Admin,,
2021-09-26,US,USA,United States,411260,398708697,688268,118923,214259208,240900,147103,189946325,310157,Admin,,
2021-09-27,US,USA,United States,1034299,399742996,735415,295035,214554243,244435,224223,190170548,290767,Admin,,
2021-09-28,US,USA,United States,1139298,400882294,800489,286896,214841139,248056,306395,190476943,284780,Admin,,
2021-09-29,US,USA,United States,1147776,402030070,868613,285867,215127006,252362,313943,190790886,281241,Admin,,
2021-09-30,US,USA,United States,1174083,403204153,939013,287795,215414801,256673,324613,191115499,280312,Admin,,
2021-10-01,US,USA,United States,1351288,404555441,990508,316063,215730864,255855,386294,191501793,276160,Admin,,
2021-10-02,US,USA,United States,634305,405189746,984616,172308,215903172,251841,209595,191711388,273167,Admin,,
2021-10-03,US,USA,United States,368579,405558325,978518,104530,216007702,249785,132247,191843635,271044,Admin,,
2021-10-04,US,USA,United States,992225,406550550,972508,244943,216252645,242629,259874,192103509,276137,Admin,,
2021-10-05,US,USA,United States,1024871,407575421,956161,242206,216494851,236245,259886,192363395,269493,Admin,,
2021-10-06,US,USA,United States,1041465,408616886,940974,246656,216741507,230643,262368,192625763,262125,Admin,,
2021-10-07,US,USA,United States,1042158,409659044,922127,251998,216993505,225529,262959,192888722,253318,Admin,,
2021-10-08,US,USA,United States,1169089,410828133,896099,284003,217277508,220949,317726,193206448,243522,Admin,,
2021-10-09,US,USA,United States,538874,411367007,882466,145708,217423216,217149,169812,193376260,237839,Admin,,
2021-10-10,US,USA,United States,317141,411684148,875118,91607,217514823,215303,106532,193482792,234165,Admin,,
2021-10-11,US,USA,United States,859259,412543407,856122,222055,217736878,212033,223506,193706298,228970,Admin,,
2021-10-12,US,USA,United States,936715,413480122,843529,226921,217963799,209850,237505,193943803,225773,Admin,,
2021-10-13,US,USA,United States,917446,414397568,825812,225775,218189574,206867,232631,194176434,221524,Admin,,
2021-10-14,US,USA,United States,920367,415317935,808413,224270,218413844,202906,232404,194408838,217159,Admin,,
2021-10-15,US,USA,United States,1065262,416383197,793581,259858,218673702,199456,282205,194691043,212085,Admin,,
2021-10-16,US,USA,United States,495788,416878985,787425,139327,218813029,198545,147440,194838483,208889,Admin,,
2021-10-17,US,USA,United States,271486,417150471,780903,82500,218895529,197244,85717,194924200,205915,Admin,,
2021-10-18,US,USA,United States,839395,417989866,778066,220607,219116136,197037,214216,195138416,204588,Admin,,
2021-10-19,US,USA,United States,831451,418821317,763028,200302,219316438,193234,195477,195333893,198584,Admin,,
2021-10-20,US,USA,United States,846753,419668070,752929,201108,219517546,189710,197421,195531314,193554,Admin,,
2021-10-21,US,USA,United States,870069,420538139,745743,204862,219722408,186938,200263,195731577,188963,Admin,,
2021-10-22,US,USA,United States,1390155,421928294,792157,287375,220009783,190869,248222,195979799,184108,Admin,,
2021-10-23,US,USA,United States,833391,422761685,840386,171752,220181535,195501,134131,196113930,182207,Admin,,
2021-10-24,US,USA,United States,475619,423237304,869548,105325,220286860,198762,80827,196194757,181508,Admin,,
2021-10-25,US,USA,United States,1538172,424775476,969373,295596,220582456,209474,205040,196399797,180197,Admin,,
2021-10-26,US,USA,United States,1576688,426352164,1075835,290740,220873196,222394,202868,196602665,181253,Admin,,
2021-10-27,US,USA,United States,1635798,427987962,1188556,299469,221172665,236446,208660,196811325,182859,Admin,,
2021-10-28,US,USA,United States,1623756,429611718,1296226,289025,221461690,248469,211267,197022592,184431,Admin,,
2021-10-29,US,USA,United States,1804326,431416044,1355393,318738,221780428,252949,240638,197263230,183347,Admin,,
2021-10-30,US,USA,United States,825374,432241418,1354248,162498,221942926,251627,119679,197382909,181283,Admin,,
2021-10-31,US,USA,United States,441216,432682634,1349333,98051,222040977,250588,70770,197453679,179846,Admin,,
2021-11-01,US,USA,United States,1506291,434188925,1344778,280445,222321422,248424,198096,197651775,178854,Admin,,
2021-11-02,US,USA,United States,1517814,435706739,1336368,277494,222598916,246531,189384,197841159,176928,Admin,,
2021-11-03,US,USA,United States,1586053,437292792,1329261,306685,222905601,247562,194180,198035339,174859,Admin,,
2021-11-04,US,USA,United States,1659723,438952515,1334400,345829,223251430,255677,196884,198232223,172804,Admin,,
2021-11-05,US,USA,United States,1939274,440891789,1353678,450466,223701896,274495,232017,198464240,171573,Admin,,
2021-11-06,US,USA,United States,1051216,441943005,1385941,392156,224094052,307304,120779,198585019,171730,Admin,,
2021-11-07,US,USA,United States,563911,442506916,1403469,228656,224322708,325962,72508,198657527,171978,Admin,,
2021-11-08,US,USA,United States,1483838,443990754,1400261,469205,224791913,352927,174961,198832488,168673,Admin,,
2021-11-09,US,USA,United States,1658855,445649609,1420410,519438,225311351,387491,167027,198999515,165479,Admin,,
2021-11-10,US,USA,United States,1796812,447446421,1450518,573341,225884692,425584,171760,199171275,162277,Admin,,
2021-11-11,US,USA,United States,1618051,449064472,1444565,546726,226431418,454284,153503,199324778,156079,Admin,,
2021-11-12,US,USA,United States,2012809,451077281,1455070,636781,227068199,480900,199911,199524689,151493,Admin,,
2021-11-13,US,USA,United States,1188490,452265771,1474681,536458,227604657,501515,103631,199628320,149043,Admin,,
2021-11-14,US,USA,United States,585003,452850774,1477694,239819,227844476,503110,61167,199689487,147423,Admin,,
2021-11-15,US,USA,United States,1571731,454422505,1490250,455815,228300291,501197,168766,199858253,146538,Admin,,
2021-11-16,US,USA,United States,1702654,456125159,1496507,483725,228784016,496095,168306,200026559,146721,Admin,,
2021-11-17,US,USA,United States,1781891,457907050,1494376,502835,229286851,486023,173462,200200021,146964,Admin,,
2021-11-18,US,USA,United States,1809855,459716905,1521776,502317,229789168,479679,172493,200372514,149677,Admin,,
2021-11-19,US,USA,United States,2101285,461818190,1534416,578896,230368064,471409,196654,200569168,149211,Admin,,
2021-11-20,US,USA,United States,1247721,463065911,1542877,457950,230826014,460194,102002,200671170,148979,Admin,,
2021-11-21,US,USA,United States,654072,463719983,1552744,205008,231031022,455221,61250,200732420,148990,Admin,,
2021-11-22,US,USA,United States,1837469,465557452,1590707,483544,231514566,459182,173176,200905596,149620,Admin,,
2021-11-23,US,USA,United States,1809705,467367157,1606000,484491,231999057,459292,166288,201071884,149332,Admin,,
2021-11-24,US,USA,United States,1403775,468770932,1551983,397631,232396688,444262,156148,201228032,146859,Admin,,
2021-11-25,US,USA,United States,29593,468800525,1297660,8824,232405512,373763,5608,201233640,123018,Admin,,
2021-11-26,US,USA,United States,1221525,470022050,1171980,307487,232712999,334991,179420,201413060,120556,Admin,,
2021-11-27,US,USA,United States,903759,470925809,1122843,214825,232927824,300259,203200,201616260,135013,Admin,,
2021-11-28,US,USA,United States,598420,471524229,1114892,138779,233066603,290797,151052,201767312,147842,Admin,,
2021-11-29,US,USA,United States,1684911,473209140,1093098,345871,233412474,271130,367873,202135185,175656,Admin,,
2021-11-30,US,USA,United States,1952368,475161508,1113479,398122,233810596,258791,398448,202533633,208821,Admin,,
2021-12-01,US,USA,United States,2209329,477370837,1228558,454083,234264679,266856,420067,202953700,246524,Admin,,
2021-12-02,US,USA,United States,2197481,479568318,1538256,440406,234705085,328510,400529,203354229,302941,Admin,,
2021-12-03,US,USA,United States,2479472,482047790,1717963,479027,235184112,353016,500685,203854914,348836,Admin,,
2021-12-04,US,USA,United States,1501892,483549682,1803410,295147,235479259,364491,462895,204317809,385936,Admin,,
2021-12-05,US,USA,United States,739364,484289046,1823545,162438,235641697,367871,192957,204510766,391922,Admin,,
2021-12-06,US,USA,United States,1855098,486144144,1847858,381808,236023505,373004,330716,204841482,386614,Admin,,
2021-12-07,US,USA,United States,1933649,488077793,1845184,395589,236419094,372643,347177,205188659,379289,Admin,,
2021-12-08,US,USA,United States,1949433,490027226,1808056,399763,236818857,364883,358057,205546716,370431,Admin,,
2021-12-09,US,USA,United States,1948310,491975536,1772460,395862,237214719,358519,344622,205891338,362444,Admin,,
2021-12-10,US,USA,United States,2141463,494116999,1724173,417653,237632372,349751,405336,206296674,348823,Admin,,
2021-12-11,US,USA,United States,1270748,495387747,1691152,261750,237894122,344980,342565,206639239,331633,Admin,,
2021-12-12,US,USA,United States,638748,496026495,1676778,148980,238043102,343058,131625,206770864,322871,Admin,,
2021-12-13,US,USA,United States,1634851,497661346,1645315,339712,238382814,337044,283221,207054085,316086,Admin,,
2021-12-14,US,USA,United States,1741286,499402632,1617834,360760,238743574,332069,291929,207346014,308194,Admin,,
2021-12-15,US,USA,United States,1742281,501144913,1588241,371605,239115179,328046,265575,207611589,294982,Admin,,
2021-12-16,US,USA,United States,1709612,502854525,1554141,382895,239498074,326194,172299,207783888,270364,Admin,,
2021-12-17,US,USA,United States,1961025,504815550,1528364,425698,239923772,327343,256429,208040317,249092,Admin,,
2021-12-18,US,USA,United States,1131526,505947076,1508476,282410,240206182,330294,164715,208205032,223685,Admin,,
2021-12-19,US,USA,United States,646705,506593781,1509612,165917,240372099,332714,82781,208287813,216707,Admin,,
2021-12-20,US,USA,United States,1860588,508454369,1541860,433969,240806068,346179,229433,208517246,209023,Admin,,
2021-12-21,US,USA,United States,1993044,510447413,1577826,458225,241264293,360103,245337,208762583,202367,Admin,,
2021-12-22,US,USA,United States,1884392,512331805,1598127,439852,241704145,369852,241764,209004347,198965,Admin,,
2021-12-23,US,USA,United States,1477060,513808865,1564906,362575,242066720,366949,179886,209184233,200049,Admin,,
2021-12-24,US,USA,United States,383840,514192705,1339594,100943,242167663,320556,57514,209241747,171633,Admin,,
2021-12-25,US,USA,United States,7017,514199722,1178949,2116,242169779,280514,1053,209242800,148253,Admin,,
2021-12-26,US,USA,United States,483412,514683134,1155622,129126,242298905,275258,84740,209327540,148532,Admin,,
2021-12-27,US,USA,United States,1540779,516223913,1109935,388387,242687292,268746,233259,209560799,149079,Admin,,
2021-12-28,US,USA,United States,1710039,517933952,1069506,429085,243116377,264583,245892,209806691,149158,Admin,,
2021-12-29,US,USA,United States,1692545,519626497,1042099,429520,243545897,263107,240686,210047377,149004,Admin,,
2021-12-30,US,USA,United States,1550287,521176784,1052560,398764,243944661,268277,217779,210265156,154418,Admin,,
2021-12-31,US,USA,United States,620908,521797692,1086427,160056,244104717,276722,95435,210360591,159835,Admin,,
2022-01-01,US,USA,United States,120312,521918004,1102612,34306,244139023,281321,17847,210378438,162234,Admin,,
2022-01-02,US,USA,United States,500641,522418645,1105073,134149,244273172,282038,91704,210470142,163229,Admin,,
2022-01-03,US,USA,United States,1252631,523671276,1063909,335976,244609148,274551,200389,210670531,158533,Admin,,
2022-01-04,US,USA,United States,1423448,525094724,1022967,365706,244974854,265497,216928,210887459,154395,Admin,,
2022-01-05,US,USA,United States,1461822,526556546,990007,373348,245348202,257472,216178,211103637,150894,Admin,,
2022-01-06,US,USA,United States,1474184,528030730,979135,367151,245715353,252956,216124,211319761,150658,Admin,,
2022-01-07,US,USA,United States,1662175,529692905,1127888,394708,246110061,286478,250179,211569940,172764,Admin,,
2022-01-08,US,USA,United States,1055313,530748218,1261459,270682,246380743,320246,177898,211747838,195629,Admin,,
2022-01-09,US,USA,United States,501167,531249385,1261534,139342,246520085,320988,76478,211824316,193453,Admin,,
2022-01-10,US,USA,United States,1268624,532518009,1263819,325675,246845760,319516,193612,212017928,192485,Admin,,
2022-01-11,US,USA,United States,1316523,533834532,1248544,333396,247179156,314900,204184,212222112,190665,Admin,,
2022-01-12,US,USA,United States,1322564,535157096,1228650,335041,247514197,309428,204066,212426178,188934,Admin,,
2022-01-13,US,USA,United States,1302017,536459113,1204055,331804,247846001,304378,191844,212618022,185466,Admin,,
2022-01-14,US,USA,United States,1480803,537939916,1178144,373779,248219780,301388,177308,212795330,175056,Admin,,
2022-01-15,US,USA,United States,795175,538735091,1140982,223189,248442969,294604,88356,212883686,162264,Admin,,
2022-01-16,US,USA,United States,393740,539128831,1125635,104791,248547760,289668,58529,212942215,159700,Admin,,
2022-01-17,US,USA,United States,831048,539959879,1063124,212081,248759841,273440,141931,213084146,152317,Admin,,
2022-01-18,US,USA,United States,1008085,540967964,1019062,250912,249010753,261657,191442,213275588,150497,Admin,,
2022-01-19,US,USA,United States,988768,541956732,971377,246612,249257365,249024,189588,213465176,148428,Admin,,
2022-01-20,US,USA,United States,945432,542902164,920436,236576,249493941,235420,179487,213644663,146663,Admin,,
2022-01-21,US,USA,United States,1093023,543995187,865039,273810,249767751,221139,164601,213809264,144848,Admin,,
2022-01-22,US,USA,United States,626291,544621478,840912,170269,249938020,213579,84466,213893730,144292,Admin,,
2022-01-23,US,USA,United States,333884,544955362,832362,89945,250027965,211458,64957,213958687,145210,Admin,,
2022-01-24,US,USA,United States,803668,545759030,828450,201046,250229011,209881,162494,214121181,148148,Admin,,
2022-01-25,US,USA,United States,810605,546569635,800239,201452,250430463,202816,177836,214299017,146204,Admin,,
2022-01-26,US,USA,United States,799954,547369589,773265,198261,250628724,195908,181760,214480777,145086,Admin,,
2022-01-27,US,USA,United States,797713,548167302,752163,195741,250824465,190075,177967,214658744,144869,Admin,,
2022-01-28,US,USA,United States,964579,549131881,733813,227575,251052040,183470,213788,214872532,151895,Admin,,
2022-01-29,US,USA,United States,473900,549605781,712043,118975,251171015,176142,113984,214986516,156112,Admin,,
2022-01-30,US,USA,United States,266955,549872736,702482,71351,251242366,173486,68089,215054605,156560,Admin,,
2022-01-31,US,USA,United States,636769,550509505,678639,158063,251400429,167345,160838,215215443,156323,Admin,,
2022-02-01,US,USA,United States,623821,551133326,651956,148374,251548803,159763,162596,215378039,154146,Admin,,
2022-02-02,US,USA,United States,579084,551712410,620403,143808,251692611,151984,156858,215534897,150589,Admin,,
2022-02-03,US,USA,United States,526655,552239065,581680,128433,251821044,142368,142142,215677039,145471,Admin,,
2022-02-04,US,USA,United States,663351,552902416,538648,151882,251972926,131555,186966,215864005,141639,Admin,,
2022-02-05,US,USA,United States,442969,553345385,534229,108170,252081096,130012,135142,215999147,144662,Admin,,
2022-02-06,US,USA,United States,215527,553560912,526882,58652,252139748,128197,62002,216061149,143792,Admin,,
2022-02-07,US,USA,United States,489174,554050086,505797,128072,252267820,123913,134301,216195450,140001,Admin,,
2022-02-08,US,USA,United States,507548,554557634,489187,125964,252393784,120712,147656,216343106,137867,Admin,,
2022-02-09,US,USA,United States,517461,555075095,480384,130163,252523947,118762,147565,216490671,136539,Admin,,
2022-02-10,US,USA,United States,515460,555590555,478784,128453,252652400,118765,142127,216632798,136537,Admin,,
2022-02-11,US,USA,United States,629700,556220255,473977,150715,252803115,118598,176543,216809341,135048,Admin,,
2022-02-12,US,USA,United States,349079,556569334,460564,89400,252892515,115917,103879,216913220,130582,Admin,,
2022-02-13,US,USA,United States,154331,556723665,451822,42449,252934964,113602,47107,216960327,128454,Admin,,
2022-02-14,US,USA,United States,346184,557069849,431395,88827,253023791,107996,99285,217059612,123452,Admin,,
2022-02-15,US,USA,United States,407091,557476940,417044,100759,253124550,104395,117145,217176757,119093,Admin,,
2022-02-16,US,USA,United States,419606,557896546,403064,103206,253227756,100544,118764,217295521,114979,Admin,,
2022-02-17,US,USA,United States,412983,558309529,388425,99413,253327169,96396,111617,217407138,110620,Admin,,
2022-02-18,US,USA,United States,532286,558841815,374509,123903,253451072,92565,144842,217551980,106091,Admin,,
2022-02-19,US,USA,United States,285072,559126887,365365,74149,253525221,90387,79317,217631297,102582,Admin,,
2022-02-20,US,USA,United States,155903,559282790,365589,42140,253567361,90342,42608,217673905,101940,Admin,,
2022-02-21,US,USA,United States,320316,559603106,361894,79507,253646868,89011,88947,217762852,100463,Admin,,
2022-02-22,US,USA,United States,357631,559960737,354828,90623,253737491,87563,100247,217863099,98049,Admin,,
2022-02-23,US,USA,United States,347723,560308460,344559,87305,253824796,85291,94392,217957491,94567,Admin,,
2022-02-24,US,USA,United States,333648,560642108,333226,82784,253907580,82916,86776,218044267,91018,Admin,,
2022-02-25,US,USA,United States,398932,561041040,314175,95697,254003277,78886,106769,218151036,85579,Admin,,
2022-02-26,US,USA,United States,245547,561286587,308529,64904,254068181,77566,65273,218216309,83573,Admin,,
2022-02-27,US,USA,United States,124434,561411021,304033,33904,254102085,76389,32210,218248519,82088,Admin,,
2022-02-28,US,USA,United States,320220,561731241,304019,76048,254178133,75895,82017,218330536,81098,Admin,,
2022-03-01,US,USA,United States,285236,562016477,293677,68525,254246658,72738,74480,218405016,77417,Admin,,
2022-03-02,US,USA,United States,262021,562278498,281434,66448,254313106,69759,72277,218477293,74257,Admin,,
2022-03-03,US,USA,United States,258059,562536557,270636,64801,254377907,67190,70052,218547345,71868,Admin,,
2022-03-04,US,USA,United States,324009,562860566,259932,79288,254457195,64845,89650,218636995,69423,Admin,,
2022-03-05,US,USA,United States,184109,563044675,251155,49389,254506584,62629,52512,218689507,67600,Admin,,
2022-03-06,US,USA,United States,90043,563134718,246242,26210,254532794,61530,24957,218714464,66564,Admin,,
2022-03-07,US,USA,United States,214483,563349201,231137,56853,254589647,58788,55716,218770180,62806,Admin,,
2022-03-08,US,USA,United States,217756,563566957,221497,55105,254644752,56871,59159,218829339,60618,Admin,,
2022-03-09,US,USA,United States,216665,563783622,215018,55950,254700702,55371,59945,218889284,58856,Admin,,
2022-03-10,US,USA,United States,216748,564000370,209116,54707,254755409,53929,60273,218949557,57459,Admin,,
2022-03-11,US,USA,United States,263258,564263628,200437,64185,254819594,51771,74688,219024245,55321,Admin,,
2022-03-12,US,USA,United States,143613,564407241,194652,39219,254858813,50318,41587,219065832,53761,Admin,,
2022-03-13,US,USA,United States,74989,564482230,192502,21669,254880482,49670,21099,219086931,53210,Admin,,
2022-03-14,US,USA,United States,198367,564680597,190199,51704,254932186,48934,52056,219138987,52687,Admin,,
2022-03-15,US,USA,United States,208108,564888705,188821,52825,254985011,48608,53361,219192348,51858,Admin,,
2022-03-16,US,USA,United States,211480,565100185,188080,54557,255039568,48409,53214,219245562,50897,Admin,,
2022-03-17,US,USA,United States,201276,565301461,185870,50825,255090393,47855,48990,219294552,49285,Admin,,
2022-03-18,US,USA,United States,256557,565558018,184913,62908,255153301,47672,62483,219357035,47541,Admin,,
2022-03-19,US,USA,United States,146728,565704746,185358,39069,255192370,47651,37278,219394313,46926,Admin,,
2022-03-20,US,USA,United States,77008,565781754,185646,22731,255215101,47803,18029,219412342,46487,Admin,,
2022-03-21,US,USA,United States,192133,565973887,184756,52037,255267138,47850,45500,219457842,45551,Admin,,
2022-03-22,US,USA,United States,185821,566159708,181572,48281,255315419,47201,44487,219502329,44283,Admin,,
2022-03-23,US,USA,United States,195878,566355586,179343,52728,255368147,46940,47111,219549440,43411,Admin,,
2022-03-24,US,USA,United States,191469,566547055,177942,52954,255421101,47244,43750,219593190,42663,Admin,,
2022-03-25,US,USA,United States,235096,566782151,174876,61947,255483048,47107,55894,219649084,41721,Admin,,
2022-03-26,US,USA,United States,125179,566907330,171798,34121,255517169,46400,30616,219679700,40770,Admin,,
2022-03-27,US,USA,United States,65215,566972545,170113,18339,255535508,45772,15144,219694844,40357,Admin,,
2022-03-28,US,USA,United States,175057,567147602,167674,50321,255585829,45527,38837,219733681,39406,Admin,,
2022-03-29,US,USA,United States,199781,567347383,169668,46629,255632458,45291,40466,219774147,38831,Admin,,
2022-03-30,US,USA,United States,405231,567752614,199575,60073,255692531,46341,58272,219832419,40426,Admin,,
2022-03-31,US,USA,United States,559568,568312182,252161,75113,255767644,49506,66554,219898973,43683,Admin,,
2022-04-01,US,USA,United States,667267,568979449,313900,78720,255846364,51902,80815,219979788,47243,Admin,,
2022-04-02,US,USA,United States,347919,569327368,345720,45025,255891389,53460,44491,220024279,49226,Admin,,
2022-04-03,US,USA,United States,211137,569538505,366566,28462,255919851,54906,25973,220050252,50773,Admin,,
2022-04-04,US,USA,United States,564170,570102675,422153,69334,255989185,57622,62285,220112537,54122,Admin,,
2022-04-05,US,USA,United States,559520,570662195,473545,62924,256052109,59950,61837,220174374,57175,Admin,,
2022-04-06,US,USA,United States,581975,571244170,498794,64552,256116661,60590,64796,220239170,58107,Admin,,
2022-04-07,US,USA,United States,587944,571832114,502847,64280,256180941,59042,63460,220302630,57665,Admin,,
2022-04-08,US,USA,United States,679572,572511686,504605,72219,256253160,58114,75514,220378144,56908,Admin,,
2022-04-09,US,USA,United States,340875,572852561,503599,43371,256296531,57877,42466,220420610,56619,Admin,,
2022-04-10,US,USA,United States,198058,573050619,501731,27129,256323660,57687,24680,220445290,56434,Admin,,
2022-04-11,US,USA,United States,584896,573635515,504691,63276,256386936,56822,62083,220507373,56405,Admin,,
2022-04-12,US,USA,United States,620155,574255670,513354,64612,256451548,57063,63690,220571063,56670,Admin,,
2022-04-13,US,USA,United States,587685,574843355,514169,65299,256516847,57169,62405,220633468,56328,Admin,,
2022-04-14,US,USA,United States,594394,575437749,515091,66115,256582962,57432,62558,220696026,56199,Admin,,
2022-04-15,US,USA,United States,573059,576010808,499875,66776,256649738,56654,64725,220760751,54658,Admin,,
2022-04-16,US,USA,United States,262009,576272817,488608,36597,256686335,55686,33151,220793902,53327,Admin,,
2022-04-17,US,USA,United States,60684,576333501,468983,11915,256698250,53513,8469,220802371,51012,Admin,,
2022-04-18,US,USA,United States,519854,576853355,459691,59417,256757667,52962,57277,220859648,50325,Admin,,
2022-04-19,US,USA,United States,547765,577401120,449350,61429,256819096,52507,57546,220917194,49447,Admin,,
2022-04-20,US,USA,United States,541443,577942563,442744,60335,256879431,51798,57872,220975066,48800,Admin,,
2022-04-21,US,USA,United States,510325,578452888,430734,58133,256937564,50657,55736,221030802,47825,Admin,,
2022-04-22,US,USA,United States,501416,578954304,420499,56681,256994245,49215,56625,221087427,46668,Admin,,
2022-04-23,US,USA,United States,262736,579217040,420603,36478,257030723,49198,33313,221120740,46691,Admin,,
2022-04-24,US,USA,United States,135526,579352566,431295,20751,257051474,50461,18119,221138859,48070,Admin,,
2022-04-25,US,USA,United States,431573,579784139,418683,49996,257101470,49115,49006,221187865,46888,Admin,,
2022-04-26,US,USA,United States,460738,580244877,406251,52074,257153544,47778,49859,221237724,45790,Admin,,
2022-04-27,US,USA,United States,479988,580724865,397472,54127,257207671,46891,51987,221289711,44949,Admin,,
2022-04-28,US,USA,United States,484070,581208935,393721,54740,257262411,46407,53293,221343004,44600,Admin,,
2022-04-29,US,USA,United States,516129,581725064,395823,58231,257320642,46628,59189,221402193,44967,Admin,,
2022-04-30,US,USA,United States,244256,581969320,393183,33912,257354554,46262,31617,221433810,44724,Admin,,
2022-05-01,US,USA,United States,136347,582105667,393300,20714,257375268,46256,17601,221451411,44650,Admin,,
2022-05-02,US,USA,United States,396110,582501777,388234,47675,257422943,45925,44874,221496285,44060,Admin,,
2022-05-03,US,USA,United States,424286,582926063,383027,49855,257472798,45608,47168,221543453,43676,Admin,,
2022-05-04,US,USA,United States,421574,583347637,374682,50187,257522985,45045,47122,221590575,42981,Admin,,
2022-05-05,US,USA,United States,415069,583762706,364824,48883,257571868,44208,47507,221638082,42154,Admin,,
2022-05-06,US,USA,United States,458222,584220928,356552,54076,257625944,43615,53950,221692032,41406,Admin,,
2022-05-07,US,USA,United States,208206,584429134,351402,29874,257655818,43038,27607,221719639,40833,Admin,,
2022-05-08,US,USA,United States,91910,584521044,345054,15827,257671645,42340,11810,221731449,40005,Admin,,
2022-05-09,US,USA,United States,393273,584914317,344649,47064,257718709,42252,44756,221776205,39989,Admin,,
2022-05-10,US,USA,United States,425935,585340252,344884,50814,257769523,42389,46436,221822641,39884,Admin,,
2022-05-11,US,USA,United States,427647,585767899,345752,50658,257820181,42457,47208,221869849,39896,Admin,,
2022-05-12,US,USA,United States,437691,586205590,348983,50574,257870755,42698,47880,221917729,39950,Admin,,
2022-05-13,US,USA,United States,476717,586682307,351626,56926,257927681,43105,52378,221970107,39725,Admin,,
2022-05-14,US,USA,United States,240789,586923096,356280,33054,257960735,43560,29848,221999955,40045,Admin,,
2022-05-15,US,USA,United States,132443,587055539,362071,20113,257980848,44172,17050,222017005,40794,Admin,,
2022-05-16,US,USA,United States,390358,587445897,361654,49575,258030423,44531,43737,222060742,40648,Admin,,
2022-05-17,US,USA,United States,414074,587859971,359960,51999,258082422,44700,44986,222105728,40441,Admin,,
2022-05-18,US,USA,United States,424157,588284128,359461,52855,258135277,45014,46958,222152686,40405,Admin,,
2022-05-19,US,USA,United States,444693,588728821,360462,53247,258188524,45396,47948,222200634,40415,Admin,,
2022-05-20,US,USA,United States,516439,589245260,366136,60085,258248609,45847,54695,222255329,40746,Admin,,
2022-05-21,US,USA,United States,271910,589517170,370582,34413,258283022,46041,31331,222286660,40958,Admin,,
2022-05-22,US,USA,United States,155326,589672496,373851,21449,258304471,46232,18672,222305332,41190,Admin,,
2022-05-23,US,USA,United States,440849,590113345,381064,53313,258357784,46766,47251,222352583,41692,Admin,,
2022-05-24,US,USA,United States,431685,590545030,383580,51930,258409714,46756,45201,222397784,41722,Admin,,
2022-05-25,US,USA,United States,419460,590964490,382909,51524,258461238,46566,45585,222443369,41526,Admin,,
2022-05-26,US,USA,United States,406415,591370905,377441,49858,258511096,46082,43319,222486688,40865,Admin,,
2022-05-27,US,USA,United States,450392,591821297,368005,55111,258566207,45371,49460,222536148,40117,Admin,,
2022-05-28,US,USA,United States,202682,592023979,358116,27326,258593533,44359,23740,222559888,39033,Admin,,
2022-05-29,US,USA,United States,113393,592137372,352125,17320,258610853,43769,13628,222573516,38312,Admin,,
2022-05-30,US,USA,United States,32285,592169657,293759,5859,258616712,36990,4217,222577733,32164,Admin,,
2022-05-31,US,USA,United States,379452,592549109,286297,50229,258666941,36747,45937,222623670,32269,Admin,,
2022-06-01,US,USA,United States,376460,592925569,280154,49117,258716058,36403,41691,222665361,31713,Admin,,
2022-06-02,US,USA,United States,363450,593289019,274016,46677,258762735,35948,39612,222704973,31184,Admin,,
2022-06-03,US,USA,United States,404716,593693735,267491,51694,258814429,35460,44743,222749716,30510,Admin,,
2022-06-04,US,USA,United States,193318,593887053,266153,26938,258841367,35405,22890,222772606,30388,Admin,,
2022-06-05,US,USA,United States,107739,593994792,265346,17033,258858400,35364,13388,222785994,30354,Admin,,
2022-06-06,US,USA,United States,321661,594316453,306685,45178,258903578,40981,37823,222823817,35155,Admin,,
2022-06-07,US,USA,United States,320757,594637210,298300,44173,258947751,40116,36223,222860040,33767,Admin,,
2022-06-08,US,USA,United States,324638,594961848,290897,44883,258992634,39511,37207,222897247,33127,Admin,,
2022-06-09,US,USA,United States,315129,595276977,283994,43641,259036275,39077,35225,222932472,32500,Admin,,
2022-06-10,US,USA,United States,349462,595626439,276101,47356,259083631,38457,40652,222973124,31915,Admin,,
2022-06-11,US,USA,United States,163544,595789983,271847,25202,259108833,38209,21086,222994210,31658,Admin,,
2022-06-12,US,USA,United States,87379,595877362,268939,15451,259124284,37983,12309,223006519,31504,Admin,,
2022-06-13,US,USA,United States,271032,596148394,261706,40380,259164664,37298,33681,223040200,30912,Admin,,
2022-06-14,US,USA,United States,280109,596428503,255899,42012,259206676,36989,33418,223073618,30511,Admin,,
2022-06-15,US,USA,United States,285095,596713598,250250,41145,259247821,36455,34582,223108200,30136,Admin,,
2022-06-16,US,USA,United States,283141,596996739,245680,41192,259289013,36105,33623,223141823,29907,Admin,,
2022-06-17,US,USA,United States,300907,597297646,238744,43524,259332537,35558,36455,223178278,29308,Admin,,
2022-06-18,US,USA,United States,132160,597429806,234260,22622,259355159,35189,17927,223196205,28856,Admin,,
2022-06-19,US,USA,United States,62821,597492627,230752,11797,259366956,34667,9175,223205380,28409,Admin,,
2022-06-20,US,USA,United States,236286,597728913,225788,36969,259403925,34180,26252,223231632,27347,Admin,,
2022-06-21,US,USA,United States,270935,597999848,224478,51436,259455361,35526,32193,223263825,27172,Admin,,
2022-06-22,US,USA,United States,287337,598287185,224798,63736,259519097,38754,33651,223297476,27039,Admin,,
2022-06-23,US,USA,United States,287438,598574623,225412,69876,259588973,42851,31609,223329085,26752,Admin,,
2022-06-24,US,USA,United States,311229,598885852,226887,78864,259667837,47900,34926,223364011,26533,Admin,,
2022-06-25,US,USA,United States,163799,599049651,231406,61872,259729709,53507,16782,223380793,26370,Admin,,
2022-06-26,US,USA,United States,79549,599129200,233796,25045,259754754,55400,9962,223390755,26482,Admin,,
2022-06-27,US,USA,United States,254774,599383974,236437,67260,259822014,59727,28980,223419735,26872,Admin,,
2022-06-28,US,USA,United States,268452,599652426,236083,71518,259893532,62596,30073,223449808,26569,Admin,,
2022-06-29,US,USA,United States,274333,599926759,234225,74896,259968428,64190,30879,223480687,26173,Admin,,
2022-06-30,US,USA,United States,283100,600209859,233605,77104,260045532,65223,31548,223512235,26164,Admin,,
2022-07-01,US,USA,United States,281197,600491056,229315,73590,260119122,64469,31373,223543608,25657,Admin,,
2022-07-02,US,USA,United States,114859,600605915,222323,31279,260150401,60099,14003,223557611,25260,Admin,,
2022-07-03,US,USA,United States,59206,600665121,219417,14860,260165261,58644,8142,223565753,25000,Admin,,
2022-07-04,US,USA,United States,13189,600678310,184905,3968,260169229,49602,1914,223567667,21133,Admin,,
2022-07-05,US,USA,United States,253077,600931387,182709,65060,260234289,48680,32845,223600512,21529,Admin,,
2022-07-06,US,USA,United States,267482,601198869,181730,69078,260303367,47848,31159,223631671,21569,Admin,,
2022-07-07,US,USA,United States,274501,601473370,180502,69374,260372741,46744,31055,223662726,21499,Admin,,
2022-07-08,US,USA,United States,308491,601781861,184401,74119,260446860,46820,34667,223697393,21969,Admin,,
2022-07-09,US,USA,United States,147757,601929618,189100,39672,260486532,48019,17071,223714464,22408,Admin,,
2022-07-10,US,USA,United States,78685,602008303,191883,21266,260507798,48934,9579,223724043,22613,Admin,,
2022-07-11,US,USA,United States,271223,602279526,228745,60032,260567830,56943,30755,223754798,26733,Admin,,
2022-07-12,US,USA,United States,303188,602582714,235904,68007,260635837,57364,32569,223787367,26694,Admin,,
2022-07-13,US,USA,United States,348023,602930737,247410,70370,260706207,57549,36305,223823672,27429,Admin,,
2022-07-14,US,USA,United States,368339,603299076,260815,72863,260779070,58047,36141,223859813,28155,Admin,,
2022-07-15,US,USA,United States,417058,603716134,276325,79473,260858543,58812,41613,223901426,29148,Admin,,
2022-07-16,US,USA,United States,214034,603930168,285793,41385,260899928,59057,21358,223922784,29760,Admin,,
2022-07-17,US,USA,United States,116268,604046436,291162,21618,260921546,59107,12749,223935533,30213,Admin,,
2022-07-18,US,USA,United States,361636,604408072,304078,67534,260989080,60179,37679,223973212,31202,Admin,,
2022-07-19,US,USA,United States,361493,604769565,312407,71139,261060219,60626,40094,224013306,32277,Admin,,
2022-07-20,US,USA,United States,346130,605115695,312137,69228,261129447,60463,41049,224054355,32955,Admin,,
2022-07-21,US,USA,United States,366165,605481860,311826,70007,261199454,60055,43662,224098017,34029,Admin,,
2022-07-22,US,USA,United States,415335,605897195,311580,74837,261274291,59393,51200,224149217,35399,Admin,,
2022-07-23,US,USA,United States,202590,606099785,309945,39040,261313331,59058,30964,224180181,36771,Admin,,
2022-07-24,US,USA,United States,99859,606199644,307601,19636,261332967,58774,14412,224194593,37009,Admin,,
2022-07-25,US,USA,United States,312003,606511647,300511,61964,261394931,57979,37329,224231922,36959,Admin,,
2022-07-26,US,USA,United States,322554,606834201,294948,64812,261459743,57075,42600,224274522,37317,Admin,,
2022-07-27,US,USA,United States,310381,607144582,289841,62861,261522604,56165,42404,224316926,37510,Admin,,
2022-07-28,US,USA,United States,308462,607453044,281598,62396,261585000,55078,43941,224360867,37550,Admin,,
2022-07-29,US,USA,United States,324200,607777244,268578,65102,261650102,53687,46944,224407811,36942,Admin,,
2022-07-30,US,USA,United States,140767,607918011,259747,31307,261681409,52583,21359,224429170,35570,Admin,,
2022-07-31,US,USA,United States,69427,607987438,255399,16262,261697671,52101,10209,224439379,34969,Admin,,
2022-08-01,US,USA,United States,244054,608231492,245692,54593,261752264,51048,31208,224470587,34095,Admin,,
2022-08-02,US,USA,United States,259088,608490580,236626,57806,261810070,50047,37022,224507609,33298,Admin,,
2022-08-03,US,USA,United States,253674,608744254,228525,57597,261867667,49295,36480,224544089,32452,Admin,,
2022-08-04,US,USA,United States,249672,608993926,220126,56740,261924407,48487,35611,224579700,31262,Admin,,
2022-08-05,US,USA,United States,267691,609261617,212053,59635,261984042,47706,40313,224620013,30315,Admin,,
2022-08-06,US,USA,United States,124479,609386096,209726,29221,262013263,47408,22459,224642472,30472,Admin,,
2022-08-07,US,USA,United States,63918,609450014,208939,15026,262028289,47231,12583,224655055,30811,Admin,,
2022-08-08,US,USA,United States,220894,609670908,205631,50801,262079090,46689,32709,224687764,31025,Admin,,
2022-08-09,US,USA,United States,228768,609899676,201299,52496,262131586,45931,34729,224722493,30698,Admin,,
2022-08-10,US,USA,United States,215055,610114731,195782,50436,262182022,44908,32644,224755137,30150,Admin,,
2022-08-11,US,USA,United States,218227,610332958,191290,52038,262234060,44236,33550,224788687,29855,Admin,,
2022-08-12,US,USA,United States,240004,610572962,187335,55408,262289468,43632,38403,224827090,29582,Admin,,
2022-08-13,US,USA,United States,107195,610680157,184866,26574,262316042,43254,19293,224846383,29130,Admin,,
2022-08-14,US,USA,United States,52877,610733034,183289,13858,262329900,43087,9050,224855433,28625,Admin,,
2022-08-15,US,USA,United States,197625,610930659,179964,46468,262376368,42468,30842,224886275,28359,Admin,,
2022-08-16,US,USA,United States,204834,611135493,176545,48682,262425050,41923,32085,224918360,27981,Admin,,
2022-08-17,US,USA,United States,202283,611337776,174721,48072,262473122,41586,31712,224950072,27848,Admin,,
2022-08-18,US,USA,United States,194850,611532626,171381,47447,262520569,40930,31140,224981212,27504,Admin,,
2022-08-19,US,USA,United States,213278,611745904,167563,51341,262571910,40349,36576,225017788,27243,Admin,,
2022-08-20,US,USA,United States,87874,611833778,164803,22412,262594322,39754,16039,225033827,26778,Admin,,
2022-08-21,US,USA,United States,43716,611877494,163494,11746,262606068,39453,7668,225041495,26580,Admin,,
2022-08-22,US,USA,United States,166929,612044423,159109,41552,262647620,38750,27210,225068705,26061,Admin,,
2022-08-23,US,USA,United States,176526,612220949,155065,43730,262691350,38043,29412,225098117,25680,Admin,,
2022-08-24,US,USA,United States,174687,612395636,151123,43431,262734781,37380,29468,225127585,25359,Admin,,
2022-08-25,US,USA,United States,171199,612566835,147744,43779,262778560,36856,29319,225156904,25099,Admin,,
2022-08-26,US,USA,United States,180405,612747240,143048,45247,262823807,35985,32588,225189492,24529,Admin,,
2022-08-27,US,USA,United States,78281,612825521,141678,20631,262844438,35731,15447,225204939,24445,Admin,,
2022-08-28,US,USA,United States,38382,612863903,140916,10494,262854932,35552,7264,225212203,24387,Admin,,
2022-08-29,US,USA,United States,141466,613005369,137278,35564,262890496,34697,24848,225237051,24049,Admin,,
2022-08-30,US,USA,United States,148545,613153914,133281,38821,262929317,33995,25752,225262803,23527,Admin,,
2022-08-31,US,USA,United States,134574,613288488,127550,36112,262965429,32950,25173,225287976,22913,Admin,,
2022-09-01,US,USA,United States,98820,613387308,117210,31104,262996533,31139,21088,225309064,21737,Admin,,
2022-09-02,US,USA,United States,90504,613477812,104367,30908,263027441,29091,23577,225332641,20450,Admin,,
2022-09-03,US,USA,United States,56379,613534191,101239,13241,263040682,28035,10711,225343352,19773,Admin,,
2022-09-04,US,USA,United States,42999,613577190,101898,9020,263049702,27824,6344,225349696,19642,Admin,,
2022-09-05,US,USA,United States,13378,613590568,83600,3882,263053584,23298,2089,225351785,16391,Admin,,
2022-09-06,US,USA,United States,178033,613768601,87812,36444,263090028,22959,29293,225381078,16896,Admin,,
2022-09-07,US,USA,United States,401355,614169956,125924,53786,263143814,25484,41887,225422965,19284,Admin,,
2022-09-08,US,USA,United States,432377,614602333,173575,55600,263199414,28983,43259,225466224,22451,Admin,,
2022-09-09,US,USA,United States,566315,615168648,241548,66875,263266289,34121,55720,225521944,27043,Admin,,
2022-09-10,US,USA,United States,319397,615488045,279122,35464,263301753,37296,33714,225555658,30329,Admin,,
2022-09-11,US,USA,United States,203014,615691059,301981,22689,263324442,39249,18669,225574327,32090,Admin,,
2022-09-12,US,USA,United States,552786,616243845,379040,59952,263384394,47259,48503,225622830,38721,Admin,,
2022-09-13,US,USA,United States,535677,616779522,430132,58351,263442745,50388,47379,225670209,41304,Admin,,
2022-09-14,US,USA,United States,576722,617356244,455184,61109,263503854,51434,50683,225720892,42561,Admin,,
2022-09-15,US,USA,United States,584272,617940516,476883,62510,263566364,52421,51800,225772692,43781,Admin,,
2022-09-16,US,USA,United States,705764,618646280,496805,73445,263639809,53360,63469,225836161,44888,Admin,,
2022-09-17,US,USA,United States,340210,618986490,499778,36449,263676258,53501,30802,225866963,44472,Admin,,
2022-09-18,US,USA,United States,194963,619181453,498628,22351,263698609,53452,16867,225883830,44215,Admin,,
2022-09-19,US,USA,United States,618320,619799773,507990,63188,263761797,53915,50853,225934683,44550,Admin,,
2022-09-20,US,USA,United States,630469,620430242,521531,62995,263824792,54578,52347,225987030,45260,Admin,,
2022-09-21,US,USA,United States,688130,621118372,537447,67485,263892277,55489,56634,226043664,46110,Admin,,
2022-09-22,US,USA,United States,682616,621800988,551496,67127,263959404,56149,56443,226100107,46774,Admin,,
2022-09-23,US,USA,United States,815182,622616170,567127,79427,264038831,57003,67784,226167891,47390,Admin,,
2022-09-24,US,USA,United States,380998,622997168,572954,38375,264077206,57278,33443,226201334,47767,Admin,,
2022-09-25,US,USA,United States,216859,623214027,576082,23230,264100436,57404,17343,226218677,47835,Admin,,
2022-09-26,US,USA,United States,715738,623929765,589999,67636,264168072,58039,53133,226271810,48161,Admin,,
2022-09-27,US,USA,United States,710730,624640495,601465,66390,264234462,58524,54180,226325990,48423,Admin,,
2022-09-28,US,USA,United States,734370,625374865,608070,68982,264303444,58738,57410,226383400,48534,Admin,,
2022-09-29,US,USA,United States,719209,626094074,613298,67340,264370784,58769,57274,226440674,48652,Admin,,
2022-09-30,US,USA,United States,828035,626922109,615134,75865,264446649,58260,65371,226506045,48308,Admin,,
2022-10-01,US,USA,United States,379399,627301508,614906,35523,264482172,57852,29238,226535283,47707,Admin,,
2022-10-02,US,USA,United States,209289,627510797,613824,21695,264503867,57633,16598,226551881,47601,Admin,,
2022-10-03,US,USA,United States,720944,628231741,614568,66029,264569896,57403,52714,226604595,47541,Admin,,
2022-10-04,US,USA,United States,727709,628959450,616994,65682,264635578,57302,54149,226658744,47536,Admin,,
2022-10-05,US,USA,United States,797679,629757129,626038,71997,264707575,57733,58268,226717012,47659,Admin,,
2022-10-06,US,USA,United States,777999,630535128,634436,70739,264778314,58219,57148,226774160,47641,Admin,,
2022-10-07,US,USA,United States,877814,631412942,641548,79256,264857570,58703,66099,226840259,47745,Admin,,
2022-10-08,US,USA,United States,410115,631823057,645936,38225,264895795,59089,30461,226870720,47920,Admin,,
2022-10-09,US,USA,United States,222397,632045454,647808,23317,264919112,59321,17275,226887995,48016,Admin,,
2022-10-10,US,USA,United States,741564,632787018,650754,65296,264984408,59216,54056,226942051,48208,Admin,,
2022-10-11,US,USA,United States,763542,633550560,655873,67290,265051698,59446,55072,226997123,48340,Admin,,
2022-10-12,US,USA,United States,824063,634374623,659642,74559,265126257,59812,59744,227056867,48551,Admin,,
2022-10-13,US,USA,United States,785001,635159624,660642,71752,265198009,59956,56891,227113758,48514,Admin,,
2022-10-14,US,USA,United States,891898,636051522,662654,80774,265278783,60173,65582,227179340,48440,Admin,,
2022-10-15,US,USA,United States,387507,636439029,659425,36875,265315658,59980,28826,227208166,48207,Admin,,
2022-10-16,US,USA,United States,213187,636652216,658109,22903,265338561,59921,16597,227224763,48110,Admin,,
2022-10-17,US,USA,United States,763940,637416156,661305,71644,265410205,60828,55139,227279902,48264,Admin,,
2022-10-18,US,USA,United States,762575,638178731,661167,69758,265479963,61181,54477,227334379,48179,Admin,,
2022-10-19,US,USA,United States,798688,638977419,657542,74681,265554644,61198,57995,227392374,47930,Admin,,
2022-10-20,US,USA,United States,770493,639747912,655470,71898,265626542,61219,56080,227448454,47814,Admin,,
2022-10-21,US,USA,United States,857460,640605372,650550,79203,265705745,60995,62839,227511293,47422,Admin,,
2022-10-22,US,USA,United States,385028,640990400,650196,36305,265742050,60913,28193,227539486,47331,Admin,,
2022-10-23,US,USA,United States,209544,641199944,649675,22314,265764364,60829,15769,227555255,47213,Admin,,
2022-10-24,US,USA,United States,747316,641947260,647301,69011,265833375,60453,53756,227609011,47016,Admin,,
2022-10-25,US,USA,United States,768556,642715816,648155,70030,265903405,60492,54806,227663817,47063,Admin,,
2022-10-26,US,USA,United States,844834,643560650,654747,76920,265980325,60812,59582,227723399,47289,Admin,,
2022-10-27,US,USA,United States,789043,644349693,657397,71741,266052066,60789,55688,227779087,47233,Admin,,
2022-10-28,US,USA,United States,860676,645210369,657857,77209,266129275,60504,62209,227841296,47143,Admin,,
2022-10-29,US,USA,United States,371805,645582174,655968,34353,266163628,60225,26584,227867880,46913,Admin,,
2022-10-30,US,USA,United States,193902,645776076,653733,19718,266183346,59855,14144,227882024,46681,Admin,,
2022-10-31,US,USA,United States,608416,646384492,633890,57522,266240868,58213,42185,227924209,45028,Admin,,
2022-11-01,US,USA,United States,640148,647024640,615546,61109,266301977,56939,46110,227970319,43786,Admin,,
2022-11-02,US,USA,United States,656703,647681343,588670,65175,266367152,55261,48567,228018886,42212,Admin,,
2022-11-03,US,USA,United States,641737,648323080,567627,65114,266432266,54314,48282,228067168,41154,Admin,,
2022-11-04,US,USA,United States,756729,649079809,552777,75863,266508129,54122,57331,228124499,40458,Admin,,
2022-11-05,US,USA,United States,343240,649423049,548696,34536,266542665,54148,25556,228150055,40311,Admin,,
2022-11-06,US,USA,United States,180259,649603308,546747,20480,266563145,54257,13990,228164045,40289,Admin,,
2022-11-07,US,USA,United States,584476,650187784,543327,59039,266622184,54474,43099,228207144,40419,Admin,,
2022-11-08,US,USA,United States,564752,650752536,532557,58442,266680626,54093,42259,228249403,39869,Admin,,
2022-11-09,US,USA,United States,556135,651308671,518190,58369,266738995,53120,42930,228292333,39064,Admin,,
2022-11-10,US,USA,United States,558061,651866732,506236,58570,266797565,52186,42879,228335212,38292,Admin,,
2022-11-11,US,USA,United States,601188,652467920,484016,59182,266856747,49803,46073,228381285,36684,Admin,,
2022-11-12,US,USA,United States,282595,652750515,475352,29767,266886514,49121,21862,228403147,36156,Admin,,
2022-11-13,US,USA,United States,158884,652909399,472299,19133,266905647,48929,12560,228415707,35952,Admin,,
2022-11-14,US,USA,United States,516543,653425942,462594,53886,266959533,48193,39782,228455489,35478,Admin,,
2022-11-15,US,USA,United States,523884,653949826,456756,55747,267015280,47808,40814,228496303,35271,Admin,,
2022-11-16,US,USA,United States,527964,654477790,452731,56934,267072214,47603,41582,228537885,35079,Admin,,
2022-11-17,US,USA,United States,512090,654989880,446164,56371,267128585,47289,40685,228578570,34765,Admin,,
2022-11-18,US,USA,United States,568075,655557955,441434,61154,267189739,47570,45113,228623683,34628,Admin,,
2022-11-19,US,USA,United States,266986,655824941,439204,29848,267219587,47582,21112,228644795,34521,Admin,,
2022-11-20,US,USA,United States,144989,655969930,437219,18631,267238218,47510,12157,228656952,34464,Admin,,
2022-11-21,US,USA,United States,455415,656425345,428486,52697,267290915,47340,37156,228694108,34088,Admin,,
2022-11-22,US,USA,United States,423822,656849167,414192,47395,267338310,46147,35753,228729861,33365,Admin,,
2022-11-23,US,USA,United States,358895,657208062,390039,41430,267379740,43932,30896,228760757,31839,Admin,,
2022-11-24,US,USA,United States,5908,657213970,317727,1120,267380860,36039,590,228761347,26111,Admin,,
2022-11-25,US,USA,United States,247410,657461380,271918,27286,267408146,31201,18720,228780067,22341,Admin,,
2022-11-26,US,USA,United States,191537,657652917,261139,22326,267430472,30126,15472,228795539,21535,Admin,,
2022-11-27,US,USA,United States,118916,657771833,257415,14958,267445430,29602,10153,228805692,21249,Admin,,
2022-11-28,US,USA,United States,335489,658107322,240282,36850,267482280,27338,27536,228833228,19874,Admin,,
2022-11-29,US,USA,United States,348552,658455874,229530,38617,267520897,26084,29172,228862400,18934,Admin,,
2022-11-30,US,USA,United States,433580,658889454,240199,48487,267569384,27092,37798,228900198,19920,Admin,,
2022-12-01,US,USA,United States,387984,659277438,294781,42166,267611550,32956,33005,228933203,24551,Admin,,
2022-12-02,US,USA,United States,438841,659716279,322128,47250,267658800,35808,37057,228970260,27170,Admin,,
2022-12-03,US,USA,United States,204104,659920383,323924,23211,267682011,35934,16790,228987050,27359,Admin,,
2022-12-04,US,USA,United States,114738,660035121,323327,14626,267696637,35887,9789,228996839,27307,Admin,,
2022-12-05,US,USA,United States,350850,660385971,325521,39448,267736085,36258,28332,229025171,27420,Admin,,
2022-12-06,US,USA,United States,365612,660751583,327958,40039,267776124,36461,29468,229054639,27463,Admin,,
2022-12-07,US,USA,United States,376109,661127692,319748,41808,267817932,35507,30697,229085336,26448,Admin,,
2022-12-08,US,USA,United States,379239,661506931,318499,41655,267859587,35434,31286,229116622,26203,Admin,,
2022-12-09,US,USA,United States,426504,661933435,316737,45879,267905466,35238,34365,229150987,25818,Admin,,
2022-12-10,US,USA,United States,215843,662149278,318414,24695,267930161,35450,16983,229167970,25846,Admin,,
2022-12-11,US,USA,United States,124080,662273358,319748,15975,267946136,35643,10186,229178156,25902,Admin,,
2022-12-12,US,USA,United States,366639,662639997,322004,41170,267987306,35889,29146,229207302,26019,Admin,,
2022-12-13,US,USA,United States,368284,663008281,322385,41932,268029238,36159,29256,229236558,25988,Admin,,
2022-12-14,US,USA,United States,349758,663358039,318621,40429,268069667,35962,28828,229265386,25721,Admin,,
2022-12-15,US,USA,United States,324009,663682048,310731,38267,268107934,35478,26034,229291420,24971,Admin,,
2022-12-16,US,USA,United States,380625,664062673,304177,42224,268150158,34956,30502,229321922,24419,Admin,,
2022-12-17,US,USA,United States,197222,664259895,301517,23413,268173571,34773,16702,229338624,24379,Admin,,
2022-12-18,US,USA,United States,113955,664373850,300070,15695,268189266,34733,9974,229348598,24349,Admin,,
2022-12-19,US,USA,United States,337636,664711486,295927,40862,268230128,34689,28174,229376772,24210,Admin,,
2022-12-20,US,USA,United States,317453,665028939,288665,39323,268269451,34316,27519,229404291,23962,Admin,,
2022-12-21,US,USA,United States,288962,665317901,279980,38004,268307455,33970,25964,229430255,23553,Admin,,
2022-12-22,US,USA,United States,229178,665547079,266433,31950,268339405,33067,20749,229451004,22798,Admin,,
2022-12-23,US,USA,United States,153574,665700653,233997,22460,268361865,30244,14334,229465338,20488,Admin,,
2022-12-24,US,USA,United States,38972,665739625,211390,6693,268368558,27855,4172,229469510,18698,Admin,,
2022-12-25,US,USA,United States,2556,665742181,195476,1222,268369780,25788,166,229469676,17297,Admin,,
2022-12-26,US,USA,United States,110217,665852398,162987,18641,268388421,22613,10144,229479820,14721,Admin,,
2022-12-27,US,USA,United States,266544,666118942,155715,37317,268425738,22327,24947,229504767,14354,Admin,,
2022-12-28,US,USA,United States,261645,666380587,151812,36202,268461940,22069,24284,229529051,14114,Admin,,
2022-12-29,US,USA,United States,264355,666644942,156838,36589,268498529,22732,24247,229553298,14613,Admin,,
2022-12-30,US,USA,United States,243635,666888577,169703,32853,268531382,24217,22227,229575525,15741,Admin,,
2022-12-31,US,USA,United States,63664,666952241,173231,9857,268541239,24669,5113,229580638,15875,Admin,,
2023-01-01,US,USA,United States,9990,666962231,174293,2280,268543519,24820,772,229581410,15962,Admin,,
2023-01-02,US,USA,United States,123959,667086190,176256,20199,268563718,25042,11705,229593115,16185,Admin,,
2023-01-03,US,USA,United States,228533,667314723,170826,32379,268596097,24337,22834,229615949,15883,Admin,,
2023-01-04,US,USA,United States,217330,667532053,164495,31555,268627652,23673,21481,229637430,15483,Admin,,
2023-01-05,US,USA,United States,227803,667759856,159273,32563,268660215,23098,22368,229659798,15214,Admin,,
2023-01-06,US,USA,United States,272773,668032629,163436,36621,268696836,23636,26424,229686222,15814,Admin,,
2023-01-07,US,USA,United States,134303,668166932,173527,19213,268716049,24973,12637,229698859,16889,Admin,,
2023-01-08,US,USA,United States,68870,668235802,181939,11111,268727160,26234,6497,229705356,17707,Admin,,
2023-01-09,US,USA,United States,206269,668442071,193697,29289,268756449,27533,19656,229725012,18842,Admin,,
2023-01-10,US,USA,United States,203017,668645088,190052,28359,268784808,26959,20101,229745113,18452,Admin,,
2023-01-11,US,USA,United States,200453,668845541,187641,28814,268813622,26567,19716,229764829,18200,Admin,,
2023-01-12,US,USA,United States,197394,669042935,183297,28116,268841738,25932,19524,229784353,17794,Admin,,
2023-01-13,US,USA,United States,221452,669264387,175965,30583,268872321,25069,21762,229806115,17128,Admin,,
2023-01-14,US,USA,United States,103531,669367918,171569,15169,268887490,24492,9647,229815762,16700,Admin,,
2023-01-15,US,USA,United States,47591,669415509,168530,8487,268895977,24117,4350,229820112,16394,Admin,,
2023-01-16,US,USA,United States,113064,669528573,155215,16763,268912740,22327,10976,229831088,15154,Admin,,
2023-01-17,US,USA,United States,150967,669679540,147779,23335,268936075,21610,16216,229847304,14599,Admin,,
2023-01-18,US,USA,United States,147176,669826716,140168,23250,268959325,20815,15475,229862779,13993,Admin,,
2023-01-19,US,USA,United States,141219,669967935,132143,23063,268982388,20093,15055,229877834,13354,Admin,,
2023-01-20,US,USA,United States,157321,670125256,122981,24913,269007301,19283,16423,229894257,12592,Admin,,
2023-01-21,US,USA,United States,64963,670190219,117472,11604,269018905,18774,6621,229900878,12159,Admin,,
2023-01-22,US,USA,United States,30876,670221095,115084,6508,269025413,18491,3006,229903884,11967,Admin,,
2023-01-23,US,USA,United States,119571,670340666,116013,20195,269045608,18981,12610,229916494,12201,Admin,,
2023-01-24,US,USA,United States,122922,670463588,112007,20021,269065629,18508,13718,229930212,11844,Admin,,
2023-01-25,US,USA,United States,114995,670578583,107410,20067,269085696,18053,13096,229943308,11504,Admin,,
2023-01-26,US,USA,United States,120530,670699113,104454,20602,269106298,17701,13657,229956965,11304,Admin,,
2023-01-27,US,USA,United States,130959,670830072,100688,21179,269127477,17168,15040,229972005,11107,Admin,,
2023-01-28,US,USA,United States,52513,670882585,98909,9711,269137188,16898,5881,229977886,11001,Admin,,
2023-01-29,US,USA,United States,27096,670909681,98369,6167,269143355,16849,3004,229980890,11001,Admin,,
2023-01-30,US,USA,United States,101040,671010721,95722,18311,269161666,16580,11409,229992299,10829,Admin,,
2023-01-31,US,USA,United States,102498,671113219,92804,17737,269179403,16253,11943,230004242,10576,Admin,,
2023-02-01,US,USA,United States,99647,671212866,90612,17434,269196837,15877,11747,230015989,10383,Admin,,
2023-02-02,US,USA,United States,99377,671312243,87590,17542,269214379,15440,12022,230028011,10149,Admin,,
2023-02-03,US,USA,United States,111727,671423970,84843,19284,269233663,15169,13761,230041772,9967,Admin,,
2023-02-04,US,USA,United States,46488,671470458,83982,9200,269242863,15096,5629,230047401,9931,Admin,,
2023-02-05,US,USA,United States,25048,671495506,83689,5820,269248683,15047,2927,230050328,9920,Admin,,
2023-02-06,US,USA,United States,94090,671589596,82696,17912,269266595,14990,11086,230061414,9874,Admin,,
2023-02-07,US,USA,United States,95211,671684807,81655,17290,269283885,14926,11476,230072890,9807,Admin,,
2023-02-08,US,USA,United States,93328,671778135,80753,16734,269300619,14826,11386,230084276,9755,Admin,,
2023-02-09,US,USA,United States,91407,671869542,79614,16291,269316910,14647,11451,230095727,9674,Admin,,
2023-02-10,US,USA,United States,99984,671969526,77937,17146,269334056,14342,12588,230108315,9506,Admin,,
2023-02-11,US,USA,United States,42413,672011939,77354,8331,269342387,14218,5019,230113334,9419,Admin,,
2023-02-12,US,USA,United States,18755,672030694,76455,4329,269346716,14005,2127,230115461,9305,Admin,,
2023-02-13,US,USA,United States,79338,672110032,74348,14815,269361531,13562,9433,230124894,9069,Admin,,
2023-02-14,US,USA,United States,74100,672184132,71332,13898,269375429,13078,9299,230134193,8758,Admin,,
2023-02-15,US,USA,United States,82901,672267033,69843,15384,269390813,12885,10609,230144802,8647,Admin,,
2023-02-16,US,USA,United States,79028,672346061,68074,14855,269405668,12680,9773,230154575,8407,Admin,,
2023-02-17,US,USA,United States,88440,672434501,66425,15687,269421355,12471,10882,230165457,8163,Admin,,
2023-02-18,US,USA,United States,34090,672468591,65236,7033,269428388,12286,3928,230169385,8007,Admin,,
2023-02-19,US,USA,United States,17733,672486324,65090,4092,269432480,12252,1949,230171334,7982,Admin,,
2023-02-20,US,USA,United States,62337,672548661,62661,11520,269444000,11781,7407,230178741,7692,Admin,,
2023-02-21,US,USA,United States,76008,672624669,62934,14620,269458620,11884,9768,230188509,7759,Admin,,
2023-02-22,US,USA,United States,71942,672696611,61368,13595,269472215,11629,9229,230197738,7562,Admin,,
2023-02-23,US,USA,United States,70699,672767310,60178,13817,269486032,11481,9027,230206765,7456,Admin,,
2023-02-24,US,USA,United States,79033,672846343,58835,14564,269500596,11320,10354,230217119,7380,Admin,,
2023-02-25,US,USA,United States,31860,672878203,58516,6740,269507336,11278,3853,230220972,7370,Admin,,
2023-02-26,US,USA,United States,16581,672894784,58351,3913,269511249,11253,1934,230222906,7367,Admin,,
2023-02-27,US,USA,United States,71968,672966752,59727,14343,269525592,11656,9156,230232062,7617,Admin,,
2023-02-28,US,USA,United States,72009,673038761,59156,13823,269539415,11542,9584,230241646,7591,Admin,,
2023-03-01,US,USA,United States,71437,673110198,59084,14164,269553579,11623,9621,230251267,7647,Admin,,
2023-03-02,US,USA,United States,70242,673180440,59019,14061,269567640,11658,9157,230260424,7666,Admin,,
2023-03-03,US,USA,United States,78167,673258607,58895,15007,269582647,11722,10699,230271123,7715,Admin,,
2023-03-04,US,USA,United States,31710,673290317,58873,6667,269589314,11711,3882,230275005,7719,Admin,,
2023-03-05,US,USA,United States,16682,673306999,58888,4056,269593370,11732,2007,230277012,7729,Admin,,
2023-03-06,US,USA,United States,66726,673373725,58139,13621,269606991,11628,8590,230285602,7649,Admin,,
2023-03-07,US,USA,United States,67772,673441497,57534,13444,269620435,11574,8834,230294436,7541,Admin,,
2023-03-08,US,USA,United States,66464,673507961,56823,13288,269633723,11449,9014,230303450,7455,Admin,,
2023-03-09,US,USA,United States,65648,673573609,56167,13020,269646743,11300,8781,230312231,7401,Admin,,
2023-03-10,US,USA,United States,72024,673645633,55289,14244,269660987,11191,9934,230322165,7292,Admin,,
2023-03-11,US,USA,United States,29873,673675506,55027,6944,269667931,11231,3574,230325739,7248,Admin,,
2023-03-12,US,USA,United States,15653,673691159,54880,4195,269672126,11251,1779,230327518,7215,Admin,,
2023-03-13,US,USA,United States,61452,673752611,54127,12752,269684878,11127,7734,230335252,7093,Admin,,
2023-03-14,US,USA,United States,60216,673812827,53047,12574,269697452,11002,8008,230343260,6975,Admin,,
2023-03-15,US,USA,United States,63872,673876699,52677,13370,269710822,11014,8299,230351559,6873,Admin,,
2023-03-16,US,USA,United States,61505,673938204,52085,12662,269723484,10963,8198,230359757,6789,Admin,,
2023-03-17,US,USA,United States,66662,674004866,51319,13767,269737251,10895,8746,230368503,6620,Admin,,
2023-03-18,US,USA,United States,27070,674031936,50919,6509,269743760,10833,3207,230371710,6567,Admin,,
2023-03-19,US,USA,United States,14316,674046252,50728,4136,269747896,10824,1649,230373359,6549,Admin,,
2023-03-20,US,USA,United States,60222,674106474,50552,13445,269761341,10923,7872,230381231,6568,Admin,,
2023-03-21,US,USA,United States,59759,674166233,50487,12789,269774130,10954,8184,230389415,6594,Admin,,
2023-03-22,US,USA,United States,59205,674225438,49820,12764,269786894,10867,8027,230397442,6555,Admin,,
2023-03-23,US,USA,United States,58319,674283757,49365,12213,269799107,10803,7919,230405361,6515,Admin,,
2023-03-24,US,USA,United States,65076,674348833,49138,13422,269812529,10754,8829,230414190,6527,Admin,,
2023-03-25,US,USA,United States,25501,674374334,48914,6025,269818554,10685,3313,230417503,6542,Admin,,
2023-03-26,US,USA,United States,14363,674388697,48921,3922,269822476,10654,1622,230419125,6538,Admin,,
2023-03-27,US,USA,United States,56004,674444701,48318,12123,269834599,10465,7403,230426528,6471,Admin,,
2023-03-28,US,USA,United States,56758,674501459,47889,12599,269847198,10438,7875,230434403,6427,Admin,,
2023-03-29,US,USA,United States,57808,674559267,47690,12795,269859993,10443,7997,230442400,6423,Admin,,
2023-03-30,US,USA,United States,56436,674615703,47421,12230,269872223,10445,7510,230449910,6364,Admin,,
2023-03-31,US,USA,United States,58884,674674587,46536,12294,269884517,10284,8050,230457960,6253,Admin,,
2023-04-01,US,USA,United States,21795,674696382,46007,5315,269889832,10183,2709,230460669,6167,Admin,,
2023-04-02,US,USA,United States,12184,674708566,45696,3532,269893364,10127,1432,230462101,6139,Admin,,
2023-04-03,US,USA,United States,50536,674759102,44914,11658,269905022,10060,6562,230468663,6019,Admin,,
2023-04-04,US,USA,United States,51361,674810463,44143,11965,269916987,9970,6684,230475347,5849,Admin,,
2023-04-05,US,USA,United States,50846,674861309,43149,11852,269928839,9835,6868,230482215,5688,Admin,,
2023-04-06,US,USA,United States,51872,674913181,42497,11974,269940813,9799,6971,230489186,5611,Admin,,
2023-04-07,US,USA,United States,47566,674960747,40880,10873,269951686,9596,6761,230495947,5427,Admin,,
2023-04-08,US,USA,United States,21596,674982343,40852,5865,269957551,9674,2719,230498666,5428,Admin,,
2023-04-09,US,USA,United States,6200,674988543,39997,2880,269960431,9581,850,230499516,5345,Admin,,
2023-04-10,US,USA,United States,49449,675037992,39841,11474,269971905,9555,6781,230506297,5376,Admin,,
2023-04-11,US,USA,United States,49214,675087206,39535,11439,269983344,9480,6997,230513294,5421,Admin,,
2023-04-12,US,USA,United States,48802,675136008,39243,11656,269995000,9452,6748,230520042,5404,Admin,,
2023-04-13,US,USA,United States,46454,675182462,38469,10591,270005591,9254,6371,230526413,5318,Admin,,
2023-04-14,US,USA,United States,49824,675232286,38791,11010,270016601,9274,7085,230533498,5364,Admin,,
2023-04-15,US,USA,United States,19694,675251980,38520,5710,270022311,9251,2591,230536089,5346,Admin,,
2023-04-16,US,USA,United States,9891,675261871,39047,3251,270025562,9304,1157,230537246,5390,Admin,,
2023-04-17,US,USA,United States,42586,675304457,38066,10185,270035747,9120,6067,230543313,5288,Admin,,
2023-04-18,US,USA,United States,43446,675347903,37242,9526,270045273,8847,5775,230549088,5113,Admin,,
2023-04-19,US,USA,United States,43433,675391336,36475,8279,270053552,8365,4649,230553737,4814,Admin,,
2023-04-20,US,USA,United States,58725,675450061,38228,8979,270062531,8134,5121,230558858,4635,Admin,,
2023-04-21,US,USA,United States,79992,675530053,42538,10411,270072942,8049,5917,230564775,4468,Admin,,
2023-04-22,US,USA,United States,43367,675573420,45920,5673,270078615,8043,2514,230567289,4457,Admin,,
2023-04-23,US,USA,United States,25733,675599153,48183,3570,270082185,8089,1290,230568579,4476,Admin,,
2023-04-24,US,USA,United States,85132,675684285,54261,10718,270092903,8165,5778,230574357,4435,Admin,,
2023-04-25,US,USA,United States,84228,675768513,60087,11381,270104284,8430,5617,230579974,4412,Admin,,
2023-04-26,US,USA,United States,88165,675856678,66477,11620,270115904,8907,5810,230585784,4578,Admin,,
2023-04-27,US,USA,United States,89827,675946505,70921,11142,270127046,9216,5889,230591673,4688,Admin,,
2023-04-28,US,USA,United States,97107,676043612,73366,11360,270138406,9352,6279,230597952,4740,Admin,,
2023-04-29,US,USA,United States,39915,676083527,72872,5853,270144259,9378,2377,230600329,4720,Admin,,
2023-04-30,US,USA,United States,24035,676107562,72630,4273,270148532,9478,1259,230601588,4716,Admin,,
2023-05-01,US,USA,United States,90630,676198192,73415,11909,270160441,9648,5393,230606981,4661,Admin,,
2023-05-02,US,USA,United States,94425,676292617,74872,12504,270172945,9809,5555,230612536,4652,Admin,,
2023-05-03,US,USA,United States,97533,676390150,76210,12073,270185018,9873,5502,230618038,4608,Admin,,
2023-05-04,US,USA,United States,103465,676493615,78159,12169,270197187,10020,5812,230623850,4597,Admin,,
2023-05-05,US,USA,United States,105724,676599339,79390,11810,270208997,10084,6011,230629861,4558,Admin,,
2023-05-06,US,USA,United States,40672,676640011,79498,5756,270214753,10071,2203,230632064,4534,Admin,,
2023-05-07,US,USA,United States,21386,676661397,79119,3996,270218749,10031,1075,230633139,4507,Admin,,
2023-05-08,US,USA,United States,55634,676717031,74120,6965,270225714,9325,3258,230636397,4202,Admin,,
2023-05-09,US,USA,United States,11751,676728782,62309,1467,270227181,7748,951,230637348,3545,Admin,,
